Season,Squad,Country,# Pl,Age,MP,Starts,Gls,Ast,G+A,G-PK,PK,PKatt,CrdY,CrdR
2022-2023,Ajax,Países bajos,19,26.4,6,66,11,9,20,10,1,1,15.0,1.0
2022-2023,Atlético Madrid,España,22,28.6,6,66,4,3,7,4,0,2,11.0,0.0
2022-2023,Barcelona,España,26,26.4,6,66,12,10,22,12,0,0,9.0,0.0
2022-2023,Bayern Munich,Alemania,24,26.6,10,110,21,19,40,20,1,1,20.0,1.0
2022-2023,Benfica,Portugal,24,26.0,10,110,25,16,41,20,5,5,19.0,0.0
2022-2023,Celtic,Escocia,22,26.0,6,66,3,1,4,3,0,1,7.0,0.0
2022-2023,Chelsea,Inglaterra,26,26.9,10,110,12,7,19,10,2,2,24.0,1.0
2022-2023,Club Brugge,Bélgica,25,26.3,8,88,8,7,15,7,1,2,27.0,1.0
2022-2023,Dinamo Zagreb,Croacia,20,26.9,6,66,4,2,6,4,0,0,13.0,0.0
2022-2023,Dortmund,Alemania,26,26.0,8,88,11,10,21,11,0,0,17.0,0.0
2022-2023,Eint Frankfurt,Alemania,22,26.1,8,88,7,5,12,6,1,1,18.0,2.0
2022-2023,FC Copenhagen,Dinamarca,25,24.6,6,66,1,1,2,1,0,0,12.0,1.0
2022-2023,Inter,Italia,22,28.5,13,143,19,17,36,18,1,1,25.0,0.0
2022-2023,Juventus,Italia,26,28.3,6,66,9,8,17,9,0,0,14.0,0.0
2022-2023,Leverkusen,Alemania,20,24.8,6,66,4,4,8,4,0,2,18.0,1.0
2022-2023,Liverpool,Inglaterra,25,27.5,8,88,19,15,34,18,1,1,10.0,0.0
2022-2023,Maccabi Haifa,Israel,20,28.1,6,66,7,6,13,6,1,1,14.0,0.0
2022-2023,Manchester City,Inglaterra,23,27.1,13,143,31,23,54,29,2,5,21.0,1.0
2022-2023,Marseille,Francia,19,27.0,6,66,8,6,14,7,1,1,10.0,1.0
2022-2023,Milan,Italia,23,26.3,12,132,14,9,23,12,2,3,28.0,1.0
2022-2023,Napoli,Italia,22,26.4,10,110,26,20,46,22,4,8,19.0,1.0
2022-2023,Paris S-G,Francia,21,27.5,8,88,15,12,27,14,1,1,14.0,0.0
2022-2023,Porto,Portugal,24,26.8,8,88,12,7,19,9,3,3,22.0,3.0
2022-2023,Rangers,Escocia,22,28.3,6,66,2,1,3,1,1,1,10.0,1.0
2022-2023,RB Leipzig,Alemania,22,26.1,8,88,13,12,25,13,0,0,8.0,0.0
2022-2023,RB Salzburg,Austria,19,22.5,6,66,5,3,8,4,1,1,11.0,0.0
2022-2023,Real Madrid,España,22,27.8,12,132,26,21,47,23,3,3,14.0,0.0
2022-2023,Sevilla,España,24,28.8,6,66,6,5,11,6,0,0,12.0,0.0
2022-2023,Shakhtar,Ucrania,20,24.3,6,66,8,7,15,8,0,0,15.0,0.0
2022-2023,Sporting CP,Portugal,25,25.3,6,66,8,5,13,8,0,0,17.0,3.0
2022-2023,Tottenham,Inglaterra,25,27.8,8,88,8,7,15,7,1,2,20.0,1.0
2022-2023,Viktoria Plzeň,República checa,22,28.1,6,66,5,4,9,4,1,1,12.0,1.0
2021-2022,Ajax,Países bajos,21,26.0,8,88,21,16,37,20,1,1,15.0,0.0
2021-2022,Atalanta,Italia,21,28.2,6,66,12,11,23,12,0,0,9.0,0.0
2021-2022,Atlético Madrid,España,22,27.9,10,110,9,8,17,8,1,1,24.0,4.0
2021-2022,Barcelona,España,23,25.9,6,66,2,1,3,2,0,0,13.0,1.0
2021-2022,Bayern Munich,Alemania,24,26.9,10,110,30,23,53,27,3,4,12.0,0.0
2021-2022,Benfica,Portugal,24,27.7,10,110,13,10,23,12,1,1,20.0,0.0
2021-2022,Beşiktaş,Turquía,26,28.0,6,66,3,2,5,2,1,1,16.0,2.0
2021-2022,Chelsea,Inglaterra,24,27.4,10,110,21,15,36,19,2,2,14.0,0.0
2021-2022,Club Brugge,Bélgica,21,26.2,6,66,5,5,10,5,0,0,11.0,0.0
2021-2022,Dortmund,Alemania,23,26.2,6,66,10,8,18,8,2,2,8.0,2.0
2021-2022,Dynamo Kyiv,Ucrania,23,25.5,6,66,1,1,2,1,0,0,10.0,0.0
2021-2022,Inter,Italia,22,29.0,8,88,9,6,15,9,0,0,12.0,2.0
2021-2022,Juventus,Italia,28,27.3,8,88,11,6,17,9,2,2,10.0,0.0
2021-2022,Lille,Francia,23,26.4,8,88,8,4,12,6,2,2,26.0,0.0
2021-2022,Liverpool,Inglaterra,28,27.3,13,143,28,21,49,27,1,2,15.0,0.0
2021-2022,Malmö,Suecia,21,28.4,6,66,1,1,2,1,0,0,14.0,1.0
2021-2022,Manchester City,Inglaterra,26,27.2,12,132,28,23,51,26,2,2,22.0,1.0
2021-2022,Manchester Utd,Inglaterra,31,27.2,8,88,12,11,23,12,0,0,17.0,1.0
2021-2022,Milan,Italia,23,26.0,6,66,5,4,9,5,0,0,17.0,1.0
2021-2022,Paris S-G,Francia,21,27.3,8,88,15,8,23,13,2,4,21.0,0.0
2021-2022,Porto,Portugal,22,26.3,6,66,4,3,7,3,1,1,17.0,3.0
2021-2022,RB Leipzig,Alemania,23,25.0,6,66,15,13,28,13,2,3,13.0,1.0
2021-2022,RB Salzburg,Austria,21,22.9,8,88,10,6,16,7,3,5,16.0,0.0
2021-2022,Real Madrid,España,25,28.0,13,143,28,21,49,25,3,3,25.0,0.0
2021-2022,Sevilla,España,22,28.9,6,66,5,3,8,3,2,2,20.0,2.0
2021-2022,Shakhtar,Ucrania,25,25.2,6,66,2,2,4,2,0,0,5.0,0.0
2021-2022,Sheriff Tiraspol,Moldavia,19,26.0,6,66,7,5,12,7,0,0,13.0,0.0
2021-2022,Sporting CP,Portugal,27,26.7,8,88,14,10,24,12,2,3,21.0,0.0
2021-2022,Villarreal,España,25,28.0,12,132,20,16,36,18,2,2,26.0,2.0
2021-2022,Wolfsburg,Alemania,21,26.1,6,66,5,4,9,5,0,0,25.0,2.0
2021-2022,Young Boys,Suiza,24,25.5,6,66,7,4,11,7,0,0,11.0,0.0
2021-2022,ruZen,Italia,21,27.9,6,66,9,6,15,8,1,2,9.0,1.0
2020-2021,Ajax,Países bajos,21,24.7,6,66,7,5,12,6,1,1,11.0,1.0
2020-2021,Atalanta,Italia,25,27.5,8,88,11,10,21,11,0,0,11.0,1.0
2020-2021,Atlético Madrid,España,20,27.0,8,88,7,6,13,7,0,0,17.0,1.0
2020-2021,Barcelona,España,27,26.0,8,88,18,12,30,12,6,7,12.0,1.0
2020-2021,Başakşehir,Turquía,21,29.5,6,66,7,5,12,7,0,0,18.0,0.0
2020-2021,Bayern Munich,Alemania,26,27.0,10,110,25,18,43,22,3,3,20.0,1.0
2020-2021,Chelsea,Inglaterra,24,26.2,13,143,23,16,39,18,5,6,20.0,0.0
2020-2021,Club Brugge,Bélgica,22,25.8,6,66,8,4,12,6,2,2,10.0,1.0
2020-2021,Dortmund,Alemania,26,25.8,10,110,19,11,30,17,2,2,9.0,0.0
2020-2021,Dynamo Kyiv,Ucrania,22,24.4,6,66,4,1,5,3,1,1,9.0,1.0
2020-2021,Ferencváros,Hungría,20,27.8,6,66,5,3,8,4,1,1,16.0,0.0
2020-2021,Inter,Italia,21,28.3,6,66,7,6,13,7,0,0,22.0,1.0
2020-2021,Juventus,Italia,22,27.6,8,88,17,14,31,15,2,2,22.0,1.0
2020-2021,Krasnodar,Rusia,23,27.8,6,66,6,4,10,5,1,1,10.0,0.0
2020-2021,Lazio,Italia,25,29.0,8,88,12,8,20,9,3,3,23.0,0.0
2020-2021,Liverpool,Inglaterra,29,26.0,10,110,14,10,24,13,1,1,17.0,0.0
2020-2021,Loko Moscow,Rusia,22,28.5,6,66,5,3,8,3,2,2,12.0,0.0
2020-2021,M'Gladbach,Alemania,21,27.0,8,88,15,9,24,13,2,2,12.0,0.0
2020-2021,Manchester City,Inglaterra,25,26.1,13,143,24,18,42,22,2,2,18.0,0.0
2020-2021,Manchester Utd,Inglaterra,23,25.7,6,66,14,7,21,10,4,4,13.0,1.0
2020-2021,Marseille,Francia,20,27.5,6,66,2,0,2,0,2,3,15.0,1.0
2020-2021,Midtjylland,Dinamarca,22,25.5,6,66,4,2,6,2,2,2,12.0,1.0
2020-2021,Olympiacos,Grecia,21,28.7,6,66,2,2,4,2,0,0,11.0,1.0
2020-2021,Paris S-G,Francia,23,27.3,12,132,21,16,37,18,3,4,31.0,4.0
2020-2021,Porto,Portugal,26,27.0,10,110,15,6,21,11,4,4,23.0,2.0
2020-2021,RB Leipzig,Alemania,20,24.8,8,88,11,10,21,10,1,1,21.0,0.0
2020-2021,RB Salzburg,Austria,19,24.9,6,66,9,6,15,9,0,0,11.0,0.0
2020-2021,Real Madrid,España,25,27.9,12,132,18,13,31,16,2,2,24.0,0.0
2020-2021,frRenn,España,26,25.7,6,66,3,1,4,1,2,2,17.0,1.0
2020-2021,Sevilla,España,25,27.9,8,88,13,8,21,12,1,1,20.0,1.0
2020-2021,Shakhtar,Ucrania,23,24.7,6,66,4,3,7,4,0,0,7.0,0.0
2020-2021,ruZen,Italia,21,27.8,6,66,3,3,6,3,0,0,13.0,0.0
2019-2020,Ajax,Países bajos,19,24.9,6,66,10,10,20,10,0,0,20.0,2.0
2019-2020,Atalanta,Italia,23,27.4,9,99,17,9,26,13,4,5,25.0,0.0
2019-2020,Atlético Madrid,España,21,26.2,9,99,13,9,22,11,2,3,16.0,0.0
2019-2020,Barcelona,España,24,27.6,9,99,13,10,23,12,1,1,25.0,1.0
2019-2020,Bayern Munich,Alemania,20,27.0,11,121,43,37,80,41,2,2,13.0,0.0
2019-2020,Benfica,Portugal,23,24.9,6,66,9,5,14,8,1,1,8.0,0.0
2019-2020,Chelsea,Inglaterra,22,25.5,8,88,12,7,19,10,2,3,14.0,1.0
2019-2020,Club Brugge,Bélgica,22,25.4,6,66,4,3,7,4,0,1,17.0,3.0
2019-2020,Dinamo Zagreb,Croacia,21,25.7,6,66,10,9,19,9,1,1,16.0,1.0
2019-2020,Dortmund,Alemania,24,25.8,8,88,10,9,19,10,0,1,14.0,2.0
2019-2020,Galatasaray,Turquía,20,29.7,6,66,1,1,2,1,0,0,21.0,0.0
2019-2020,Genk,Bélgica,20,23.5,6,66,5,4,9,5,0,0,10.0,0.0
2019-2020,Inter,Italia,20,27.9,6,66,10,9,19,10,0,1,17.0,0.0
2019-2020,Juventus,Italia,23,28.7,8,88,14,10,24,13,1,1,10.0,0.0
2019-2020,Leverkusen,Alemania,20,26.7,6,66,2,2,4,2,0,0,7.0,1.0
2019-2020,Lille,Francia,21,23.9,6,66,4,4,8,4,0,0,14.0,0.0
2019-2020,Liverpool,Inglaterra,20,27.0,8,88,15,11,26,15,0,0,9.0,0.0
2019-2020,Loko Moscow,Rusia,20,28.6,6,66,4,2,6,4,0,0,12.0,0.0
2019-2020,Lyon,Francia,24,25.0,10,110,14,9,23,12,2,2,22.0,0.0
2019-2020,Manchester City,Inglaterra,23,26.9,9,99,21,18,39,19,2,3,15.0,2.0
2019-2020,Napoli,Italia,24,27.1,8,88,13,6,19,9,4,4,14.0,0.0
2019-2020,Olympiacos,Grecia,17,26.2,6,66,8,5,13,6,2,2,14.0,1.0
2019-2020,Paris S-G,Francia,24,27.4,11,121,25,20,45,24,1,1,29.0,0.0
2019-2020,RB Leipzig,Alemania,25,24.2,10,110,16,10,26,12,4,4,20.0,0.0
2019-2020,RB Salzburg,Austria,21,24.1,6,66,16,13,29,14,2,2,8.0,0.0
2019-2020,Real Madrid,España,25,27.3,8,88,16,14,30,15,1,1,13.0,1.0
2019-2020,Red Star,Serbia,19,27.5,6,66,3,2,5,3,0,1,14.0,0.0
2019-2020,Shakhtar,Ucrania,18,28.4,6,66,8,6,14,7,1,1,11.0,2.0
2019-2020,Slavia Prague,República checa,20,26.9,6,66,4,3,7,3,1,1,16.0,0.0
2019-2020,Tottenham,Inglaterra,28,26.2,8,88,18,15,33,16,2,2,14.0,0.0
2019-2020,Valencia,España,23,27.2,8,88,12,9,21,11,1,3,19.0,2.0
2019-2020,ruZen,Italia,19,28.1,6,66,6,5,11,6,0,0,17.0,1.0
2018-2019,AEK Athens,Grecia,20,26.0,6,66,2,2,4,2,0,0,13.0,2.0
2018-2019,Ajax,Países bajos,22,24.3,12,132,22,17,39,20,2,2,28.0,1.0
2018-2019,Atlético Madrid,España,21,26.4,8,88,11,8,19,11,0,0,23.0,1.0
2018-2019,Barcelona,España,23,27.7,12,132,25,18,43,24,1,1,20.0,1.0
2018-2019,Bayern Munich,Alemania,20,28.3,8,88,15,9,24,13,2,2,12.0,1.0
2018-2019,Benfica,Portugal,20,25.5,6,66,6,3,9,6,0,0,14.0,1.0
2018-2019,Club Brugge,Bélgica,25,24.9,6,66,6,3,9,5,1,1,8.0,0.0
2018-2019,CSKA Moscow,Rusia,22,23.9,6,66,8,5,13,6,2,2,14.0,2.0
2018-2019,Dortmund,Alemania,24,25.0,8,88,10,8,18,10,0,1,11.0,0.0
2018-2019,Galatasaray,Turquía,21,28.4,6,66,5,2,7,3,2,3,14.0,1.0
2018-2019,Hoffenheim,Alemania,25,25.6,6,66,11,7,18,10,1,1,13.0,2.0
2018-2019,Inter,Italia,17,28.1,6,66,6,4,10,6,0,0,15.0,0.0
2018-2019,Juventus,Italia,22,28.4,10,110,14,11,25,11,3,3,16.0,1.0
2018-2019,Liverpool,Inglaterra,20,26.1,13,143,24,17,41,20,4,5,21.0,0.0
2018-2019,Loko Moscow,Rusia,19,29.0,6,66,3,2,5,3,0,1,16.0,1.0
2018-2019,Lyon,Francia,21,24.4,8,88,13,9,22,13,0,0,13.0,0.0
2018-2019,Manchester City,Inglaterra,21,26.7,10,110,30,20,50,27,3,4,16.0,1.0
2018-2019,Manchester Utd,Inglaterra,26,26.2,10,110,9,5,14,7,2,2,20.0,1.0
2018-2019,Monaco,Francia,29,25.0,6,66,2,1,3,2,0,1,13.0,0.0
2018-2019,Napoli,Italia,18,28.2,6,66,7,5,12,6,1,1,13.0,0.0
2018-2019,Paris S-G,Francia,20,27.0,8,88,19,14,33,19,0,0,18.0,0.0
2018-2019,Porto,Portugal,25,27.9,10,110,20,15,35,16,4,5,20.0,0.0
2018-2019,PSV Eindhoven,Países bajos,18,24.4,6,66,6,5,11,6,0,0,14.0,0.0
2018-2019,Real Madrid,España,24,27.0,8,88,15,12,27,15,0,0,13.0,1.0
2018-2019,Red Star,Serbia,20,26.8,6,66,5,3,8,5,0,0,17.0,0.0
2018-2019,Roma,Italia,24,27.4,8,88,14,12,26,13,1,1,12.0,1.0
2018-2019,Schalke 04,Alemania,27,26.2,8,88,8,4,12,5,3,3,16.0,0.0
2018-2019,Shakhtar,Ucrania,20,27.5,6,66,8,8,16,8,0,0,10.0,0.0
2018-2019,Tottenham,Inglaterra,24,27.0,13,143,20,17,37,20,0,0,23.0,1.0
2018-2019,Valencia,España,22,25.9,6,66,5,2,7,5,0,1,20.0,0.0
2018-2019,Viktoria Plzeň,República checa,21,29.6,6,66,7,6,13,7,0,1,10.0,0.0
2018-2019,Young Boys,Suiza,20,26.1,6,66,4,1,5,2,2,2,15.0,2.0
2017-2018,Anderlecht,Bélgica,20,26.1,6,66,1,1,2,1,0,0,,
2017-2018,APOEL FC,Chipre,21,29.7,6,66,2,1,3,2,0,0,,
2017-2018,Atlético Madrid,España,20,27.0,6,66,5,4,9,4,1,1,,
2017-2018,Barcelona,España,22,27.8,10,110,12,11,23,12,0,0,,
2017-2018,Basel,Suiza,21,25.4,8,88,13,6,19,12,1,1,,
2017-2018,Bayern Munich,Alemania,22,27.5,12,132,24,17,41,23,1,1,,
2017-2018,Benfica,Portugal,25,26.8,6,66,1,1,2,1,0,0,,
2017-2018,Beşiktaş,Turquía,23,30.2,8,88,12,8,20,10,2,2,,
2017-2018,Celtic,Escocia,20,26.1,6,66,5,4,9,5,0,0,,
2017-2018,Chelsea,Inglaterra,19,26.9,8,88,15,9,24,13,2,2,,
2017-2018,CSKA Moscow,Rusia,20,28.1,6,66,7,4,11,6,1,1,,
2017-2018,Dortmund,Alemania,22,26.2,6,66,7,6,13,7,0,0,,
2017-2018,Feyenoord,Países bajos,23,25.1,6,66,5,4,9,5,0,1,,
2017-2018,Juventus,Italia,23,29.5,10,110,14,9,23,13,1,2,,
2017-2018,Liverpool,Inglaterra,24,25.6,13,143,41,35,76,40,1,3,,
2017-2018,Manchester City,Inglaterra,25,25.9,10,110,20,16,36,19,1,2,,
2017-2018,Manchester Utd,Inglaterra,25,26.5,8,88,12,7,19,10,2,3,,
2017-2018,Monaco,Francia,23,26.0,6,66,6,4,10,5,1,1,,
2017-2018,Napoli,Italia,20,27.9,6,66,11,6,17,8,3,4,,
2017-2018,NK Maribor,Eslovenia,17,28.5,6,66,3,3,6,3,0,0,,
2017-2018,Olympiacos,Grecia,22,26.9,6,66,4,3,7,4,0,0,,
2017-2018,Paris S-G,Francia,19,26.2,8,88,26,18,44,25,1,1,,
2017-2018,Porto,Portugal,25,26.6,8,88,14,13,27,14,0,0,,
2017-2018,Qarabağ FK,Azerbaiyán,20,28.4,6,66,2,2,4,2,0,0,,
2017-2018,RB Leipzig,Alemania,19,23.9,6,66,9,5,14,8,1,1,,
2017-2018,Real Madrid,España,23,27.8,13,143,33,19,52,29,4,4,,
2017-2018,Roma,Italia,20,28.0,12,132,20,15,35,17,3,3,,
2017-2018,Sevilla,España,22,27.2,10,110,15,11,26,13,2,2,,
2017-2018,Shakhtar,Ucrania,20,27.6,8,88,11,7,18,11,0,0,,
2017-2018,Spartak Moscow,Rusia,20,27.9,6,66,9,7,16,9,0,0,,
2017-2018,Sporting CP,Portugal,21,26.6,6,66,7,7,14,7,0,0,,
2017-2018,Tottenham,Inglaterra,26,25.6,8,88,17,15,32,17,0,0,,
2016-2017,Arsenal,Inglaterra,21,26.3,8,88,19,13,32,18,1,2,0.0,1.0
2016-2017,Atlético Madrid,España,20,26.6,12,132,15,9,24,12,3,4,0.0,0.0
2016-2017,Barcelona,España,23,27.0,10,110,25,17,42,22,3,4,0.0,1.0
2016-2017,Basel,Suiza,18,27.0,6,66,3,2,5,3,0,0,0.0,1.0
2016-2017,Bayern Munich,Alemania,21,28.3,10,110,26,13,39,22,4,5,0.0,2.0
2016-2017,Benfica,Portugal,25,25.5,8,88,11,6,17,9,2,2,0.0,0.0
2016-2017,Beşiktaş,Turquía,21,29.2,6,66,9,3,12,7,2,2,0.0,1.0
2016-2017,Celtic,Escocia,22,26.5,6,66,4,2,6,3,1,2,0.0,0.0
2016-2017,Club Brugge,Bélgica,21,26.8,6,66,2,2,4,2,0,0,0.0,0.0
2016-2017,CSKA Moscow,Rusia,19,27.9,6,66,5,4,9,4,1,1,0.0,0.0
2016-2017,Dinamo Zagreb,Croacia,24,24.4,6,66,0,0,0,0,0,0,0.0,1.0
2016-2017,Dortmund,Alemania,25,25.1,10,110,27,21,48,26,1,2,0.0,0.0
2016-2017,Dynamo Kyiv,Ucrania,24,26.1,6,66,8,5,13,7,1,2,0.0,1.0
2016-2017,FC Copenhagen,Dinamarca,19,25.5,6,66,5,5,10,5,0,1,0.0,1.0
2016-2017,Juventus,Italia,25,29.9,13,144,21,10,31,18,3,3,0.0,2.0
2016-2017,Legia Warsaw,Polonia,22,28.0,6,66,9,8,17,8,1,1,0.0,1.0
2016-2017,Leicester City,Inglaterra,26,28.0,10,110,11,5,16,9,2,2,0.0,0.0
2016-2017,Leverkusen,Alemania,26,24.6,8,88,8,5,13,8,0,1,0.0,0.0
2016-2017,Ludogorets,Bulgaria,19,28.5,6,66,6,4,10,6,0,1,0.0,0.0
2016-2017,Lyon,Francia,21,25.3,6,66,5,5,10,5,0,1,0.0,0.0
2016-2017,M'Gladbach,Alemania,19,25.5,6,66,5,4,9,5,0,0,0.0,1.0
2016-2017,Manchester City,Inglaterra,22,28.1,8,88,18,14,32,17,1,1,0.0,1.0
2016-2017,Monaco,Francia,23,25.3,12,132,21,14,35,21,0,3,0.0,1.0
2016-2017,Napoli,Italia,21,26.7,8,88,13,9,22,11,2,3,0.0,0.0
2016-2017,Paris S-G,Francia,24,26.6,8,88,17,14,31,16,1,1,0.0,1.0
2016-2017,Porto,Portugal,23,26.0,8,88,9,7,16,7,2,2,0.0,1.0
2016-2017,PSV Eindhoven,Países bajos,20,24.9,6,66,4,2,6,4,0,2,0.0,0.0
2016-2017,Real Madrid,España,23,27.4,13,143,34,30,64,34,0,0,0.0,0.0
2016-2017,Rostov,Rusia,18,29.0,6,66,6,4,10,5,1,1,0.0,0.0
2016-2017,Sevilla,España,22,27.4,8,88,9,8,17,9,0,3,0.0,2.0
2016-2017,Sporting CP,Portugal,21,26.2,6,66,5,2,7,4,1,1,0.0,1.0
2016-2017,Tottenham,Inglaterra,21,24.9,6,66,5,5,10,4,1,1,0.0,0.0
2015-2016,Arsenal,Inglaterra,24,27.2,8,88,13,12,25,12,1,1,,
2015-2016,Atlético Madrid,España,23,26.3,13,143,16,13,29,15,1,1,,
2015-2016,Barcelona,España,25,27.1,10,112,22,17,39,20,2,2,,
2015-2016,BATE Borisov,Bielorrusia,20,26.2,12,66,5,5,10,5,0,0,,
2015-2016,Bayern Munich,Alemania,23,26.8,12,132,30,21,51,29,1,0,,
2015-2016,Benfica,Portugal,25,26.6,10,110,15,12,27,15,0,0,,
2015-2016,Chelsea,Inglaterra,21,26.6,8,88,13,7,20,12,1,2,,
2015-2016,CSKA Moscow,Rusia,19,28.0,10,66,5,3,8,2,3,4,,
2015-2016,Dinamo Zagreb,Croacia,20,26.3,12,66,3,2,5,3,0,0,,
2015-2016,Dynamo Kyiv,Ucrania,21,27.2,8,88,9,4,13,8,1,1,,
2015-2016,FC Astana,Kazajistán,21,26.9,12,66,3,3,6,3,0,0,,
2015-2016,Galatasaray,Turquía,19,29.2,6,66,5,4,9,4,1,1,,
2015-2016,Gent,Bélgica,18,25.9,8,88,10,7,17,9,1,1,,
2015-2016,Juventus,Italia,20,28.7,8,88,10,7,17,10,0,0,,
2015-2016,Leverkusen,Alemania,18,24.1,8,66,13,9,22,11,2,2,,
2015-2016,Lyon,Francia,21,25.9,6,66,5,5,10,5,0,1,,
2015-2016,M'Gladbach,Alemania,21,25.4,6,66,8,8,16,8,0,1,,
2015-2016,Maccabi Tel Aviv,Israel,20,26.8,12,66,1,0,1,0,1,1,,
2015-2016,Malmö,Suecia,19,26.8,12,66,1,1,2,1,0,2,,
2015-2016,Manchester City,Inglaterra,22,28.4,12,132,16,13,29,15,1,1,,
2015-2016,Manchester Utd,Inglaterra,23,25.6,8,66,6,5,11,5,1,1,,
2015-2016,Olympiacos,Grecia,18,25.9,6,66,5,5,10,5,0,1,,
2015-2016,Paris S-G,Francia,21,27.9,10,110,17,15,32,17,0,1,,
2015-2016,Porto,Portugal,18,25.9,6,66,9,7,16,9,0,0,,
2015-2016,PSV Eindhoven,Países bajos,22,24.1,8,88,8,8,16,8,0,1,,
2015-2016,Real Madrid,España,22,26.7,13,143,27,17,44,25,2,0,,
2015-2016,Roma,Italia,24,26.0,8,88,11,8,19,10,1,2,,
2015-2016,Sevilla,España,19,27.0,6,66,8,4,12,5,3,4,,
2015-2016,Shakhtar,Ucrania,22,27.5,10,66,7,4,11,5,2,2,,
2015-2016,Valencia,España,22,24.6,8,66,3,2,5,3,0,0,,
2015-2016,Wolfsburg,Alemania,22,27.0,10,110,14,10,24,13,1,1,,
2015-2016,ruZen,Italia,24,28.4,8,88,14,13,27,14,0,0,,
2014-2015,Ajax,Países bajos,19,23.6,6,66,8,6,14,7,1,1,0.0,0.0
2014-2015,Anderlecht,Bélgica,21,23.7,6,66,8,4,12,7,1,1,0.0,0.0
2014-2015,APOEL FC,Chipre,21,28.9,10,66,1,0,1,0,1,1,0.0,0.0
2014-2015,Arsenal,Inglaterra,29,25.4,10,88,18,9,27,17,1,1,0.0,0.0
2014-2015,Athletic Club,España,20,26.9,8,66,5,5,10,5,0,0,0.0,0.0
2014-2015,Atlético Madrid,España,23,27.4,10,110,15,10,25,15,0,0,0.0,0.0
2014-2015,Barcelona,España,22,26.8,13,143,31,26,57,31,0,1,0.0,0.0
2014-2015,Basel,Suiza,23,25.1,8,88,8,6,14,8,0,0,0.0,0.0
2014-2015,BATE Borisov,Bielorrusia,20,25.3,12,66,2,1,3,2,0,0,0.0,0.0
2014-2015,Bayern Munich,Alemania,24,26.7,12,132,33,23,56,29,4,4,0.0,0.0
2014-2015,Benfica,Portugal,24,27.5,6,66,2,2,4,2,0,0,0.0,0.0
2014-2015,Chelsea,Inglaterra,24,27.1,8,88,18,12,30,14,4,5,0.0,0.0
2014-2015,CSKA Moscow,Rusia,18,27.0,6,66,6,4,10,5,1,1,0.0,0.0
2014-2015,Dortmund,Alemania,24,26.5,8,88,14,12,26,14,0,0,0.0,0.0
2014-2015,Galatasaray,Turquía,22,27.7,6,66,4,2,6,3,1,1,0.0,0.0
2014-2015,Juventus,Italia,24,29.3,13,143,16,11,27,14,2,3,0.0,0.0
2014-2015,Leverkusen,Alemania,21,25.2,10,88,8,7,15,7,1,1,0.0,0.0
2014-2015,Liverpool,Inglaterra,21,25.7,6,66,5,1,6,4,1,1,0.0,0.0
2014-2015,Ludogorets,Bulgaria,19,27.4,12,66,5,4,9,5,0,0,0.0,0.0
2014-2015,Malmö,Suecia,17,25.1,12,66,4,2,6,4,0,0,0.0,0.0
2014-2015,Manchester City,Inglaterra,20,28.7,8,88,10,4,14,8,2,3,0.0,0.0
2014-2015,Monaco,Francia,22,25.9,10,110,7,7,14,7,0,0,0.0,0.0
2014-2015,NK Maribor,Eslovenia,17,27.3,12,66,3,1,4,3,0,1,0.0,0.0
2014-2015,Olympiacos,Grecia,19,26.7,6,66,10,8,18,10,0,0,0.0,0.0
2014-2015,Paris S-G,Francia,19,27.2,10,110,13,11,24,13,0,0,0.0,0.0
2014-2015,Porto,Portugal,23,24.4,12,110,25,12,37,22,3,5,0.0,0.0
2014-2015,Real Madrid,España,23,26.4,12,132,23,19,42,20,3,4,0.0,0.0
2014-2015,Roma,Italia,20,28.3,6,66,7,5,12,7,0,0,0.0,0.0
2014-2015,Schalke 04,Alemania,26,25.6,8,88,12,8,20,11,1,1,0.0,0.0
2014-2015,Shakhtar,Ucrania,20,27.0,8,88,15,11,26,12,3,3,0.0,0.0
2014-2015,Sporting CP,Portugal,19,24.1,6,66,12,5,17,9,3,3,0.0,0.0
2014-2015,ruZen,Italia,18,27.6,10,66,4,4,8,4,0,0,0.0,0.0
2013-2014,Ajax,Países bajos,21,23.5,6,66,5,3,8,5,0,1,0.0,0.0
2013-2014,Anderlecht,Bélgica,21,23.3,6,66,4,4,8,4,0,1,0.0,0.0
2013-2014,Arsenal,Inglaterra,24,26.9,10,88,9,8,17,9,0,2,0.0,0.0
2013-2014,Atlético Madrid,España,24,26.7,13,143,26,18,44,25,1,2,0.0,0.0
2013-2014,Austria Wien,Austria,19,26.1,10,66,5,4,9,5,0,0,0.0,0.0
2013-2014,Barcelona,España,24,27.6,10,110,21,16,37,18,3,3,0.0,0.0
2013-2014,Basel,Suiza,19,25.2,10,66,5,6,11,5,0,0,0.0,0.0
2013-2014,Bayern Munich,Alemania,22,26.5,12,132,24,20,44,22,2,4,0.0,0.0
2013-2014,Benfica,Portugal,21,27.0,6,66,7,4,11,6,1,1,0.0,0.0
2013-2014,Celtic,Escocia,19,25.7,12,66,3,1,4,2,1,1,0.0,0.0
2013-2014,Chelsea,Inglaterra,22,28.1,12,132,18,14,32,17,1,1,0.0,0.0
2013-2014,CSKA Moscow,Rusia,20,26.2,6,66,7,5,12,5,2,2,0.0,0.0
2013-2014,Dortmund,Alemania,23,25.9,10,110,17,11,28,15,2,2,0.0,0.0
2013-2014,FC Copenhagen,Dinamarca,19,27.5,6,66,4,3,7,4,0,0,0.0,0.0
2013-2014,Galatasaray,Turquía,23,28.3,8,88,9,8,17,9,0,0,0.0,0.0
2013-2014,Juventus,Italia,21,28.3,6,66,9,5,14,5,4,4,0.0,0.0
2013-2014,Leverkusen,Alemania,21,25.4,8,88,10,5,15,9,1,2,0.0,0.0
2013-2014,Manchester City,Inglaterra,21,27.5,8,88,19,15,34,16,3,3,0.0,0.0
2013-2014,Manchester Utd,Inglaterra,24,27.7,10,110,15,11,26,14,1,2,0.0,0.0
2013-2014,Marseille,Francia,19,26.6,6,66,5,4,9,4,1,1,0.0,0.0
2013-2014,Milan,Italia,25,28.4,10,88,7,4,11,6,1,1,0.0,0.0
2013-2014,Napoli,Italia,19,27.5,6,66,10,8,18,10,0,0,0.0,0.0
2013-2014,Olympiacos,Grecia,23,26.4,8,88,12,10,22,11,1,3,0.0,0.0
2013-2014,Paris S-G,Francia,21,26.8,10,110,24,20,44,23,1,2,0.0,0.0
2013-2014,Porto,Portugal,18,26.2,6,66,4,4,8,4,0,1,0.0,0.0
2013-2014,Real Madrid,España,22,26.5,13,143,41,35,76,39,2,4,0.0,0.0
2013-2014,Real Sociedad,España,23,26.0,8,66,1,0,1,1,0,1,0.0,0.0
2013-2014,Schalke 04,Alemania,25,25.0,10,88,8,6,14,8,0,0,0.0,0.0
2013-2014,Shakhtar,Ucrania,17,26.9,6,66,7,4,11,7,0,0,0.0,0.0
2013-2014,Steaua,Rumanía,21,26.5,12,66,2,2,4,2,0,0,0.0,0.0
2013-2014,Viktoria Plzeň,República checa,18,28.9,12,66,6,6,12,6,0,0,0.0,0.0
2013-2014,ruZen,Italia,21,27.4,12,88,8,5,13,7,1,2,0.0,0.0
2012-2013,Ajax,Países bajos,18,24.4,6,66,8,6,14,8,0,0,7.0,0.0
2012-2013,Anderlecht,Bélgica,20,26.3,10,66,4,4,8,4,0,0,17.0,1.0
2012-2013,Arsenal,Inglaterra,28,25.6,8,88,13,14,27,13,0,0,26.0,0.0
2012-2013,Barcelona,España,25,26.9,12,132,18,14,32,17,1,1,25.0,1.0
2012-2013,BATE Borisov,Bielorrusia,19,26.7,12,66,9,7,16,9,0,0,17.0,1.0
2012-2013,Bayern Munich,Alemania,21,26.3,13,143,30,24,54,29,1,2,30.0,1.0
2012-2013,Benfica,Portugal,20,25.6,6,66,5,4,9,5,0,1,16.0,0.0
2012-2013,Braga,Portugal,20,27.6,8,66,7,4,11,6,1,1,11.0,1.0
2012-2013,Celtic,Escocia,19,25.2,12,88,8,5,13,7,1,1,16.0,0.0
2012-2013,CFR Cluj,Rumanía,19,27.4,10,66,8,7,15,8,0,0,9.0,1.0
2012-2013,Chelsea,Inglaterra,19,26.3,6,66,16,9,25,15,1,2,6.0,0.0
2012-2013,Dinamo Zagreb,Croacia,19,24.0,12,66,1,0,1,0,1,1,8.0,0.0
2012-2013,Dortmund,Alemania,20,25.0,13,143,23,16,39,21,2,3,13.0,0.0
2012-2013,Dynamo Kyiv,Ucrania,21,25.9,10,66,5,5,10,5,0,0,13.0,0.0
2012-2013,Galatasaray,Turquía,22,27.6,10,110,14,12,26,14,0,0,26.0,0.0
2012-2013,Juventus,Italia,24,28.1,10,110,16,14,30,16,0,0,20.0,0.0
2012-2013,Lille,Francia,22,27.1,8,66,4,3,7,4,0,0,18.0,1.0
2012-2013,Málaga,España,24,28.2,12,110,16,14,30,15,1,2,23.0,0.0
2012-2013,Manchester City,Inglaterra,21,26.3,6,66,7,3,10,5,2,2,15.0,0.0
2012-2013,Manchester Utd,Inglaterra,28,26.1,8,88,10,7,17,9,1,2,13.0,0.0
2012-2013,Milan,Italia,28,27.2,8,88,8,7,15,8,0,0,21.0,0.0
2012-2013,Montpellier,Francia,25,26.1,6,66,6,2,8,4,2,2,15.0,1.0
2012-2013,Nordsjælland,Dinamarca,19,26.4,6,66,4,3,7,4,0,1,14.0,0.0
2012-2013,Olympiacos,Grecia,20,27.5,6,66,9,6,15,9,0,0,13.0,0.0
2012-2013,Paris S-G,Francia,25,26.8,10,110,20,16,36,19,1,1,22.0,1.0
2012-2013,Porto,Portugal,19,25.5,8,88,11,9,20,11,0,0,15.0,1.0
2012-2013,Real Madrid,España,25,26.5,12,132,26,24,50,26,0,0,25.0,2.0
2012-2013,Schalke 04,Alemania,23,24.8,8,88,13,10,23,12,1,2,17.0,0.0
2012-2013,Shakhtar,Ucrania,18,26.8,8,88,14,10,24,14,0,0,15.0,0.0
2012-2013,Spartak Moscow,Rusia,23,26.0,8,66,5,5,10,5,0,0,18.0,3.0
2012-2013,Valencia,España,23,26.5,8,88,14,7,21,11,3,3,21.0,2.0
2012-2013,ruZen,Italia,21,28.8,6,66,6,3,9,5,1,1,15.0,1.0
2011-2012,Ajax,Países bajos,20,23.5,6,66,6,4,10,6,0,0,6.0,0.0
2011-2012,APOEL FC,Chipre,23,30.6,16,110,9,7,16,7,2,2,27.0,1.0
2011-2012,Arsenal,Inglaterra,29,25.4,10,88,10,4,14,9,1,1,16.0,0.0
2011-2012,Barcelona,España,31,26.7,12,132,33,22,55,28,5,6,17.0,0.0
2011-2012,Basel,Suiza,20,24.6,8,88,12,8,20,10,2,2,18.0,1.0
2011-2012,BATE Borisov,Bielorrusia,21,24.9,12,66,2,0,2,1,1,1,8.0,0.0
2011-2012,Bayern Munich,Alemania,21,25.5,15,143,26,15,41,25,1,3,29.0,1.0
2011-2012,Benfica,Portugal,22,25.9,14,110,12,8,20,12,0,0,27.0,2.0
2011-2012,Chelsea,Inglaterra,23,27.7,13,152,27,21,48,25,2,3,31.0,1.0
2011-2012,CSKA Moscow,Rusia,23,26.2,8,88,11,10,21,11,0,0,16.0,1.0
2011-2012,Dinamo Zagreb,Croacia,19,24.3,12,66,3,2,5,3,0,0,18.0,1.0
2011-2012,Dortmund,Alemania,20,24.2,6,66,6,4,10,5,1,1,7.0,0.0
2011-2012,Genk,Bélgica,20,24.9,10,66,2,2,4,2,0,0,9.0,0.0
2011-2012,Inter,Italia,25,29.8,8,88,10,8,18,9,1,1,16.0,0.0
2011-2012,Leverkusen,Alemania,21,24.8,8,88,10,6,16,10,0,0,20.0,0.0
2011-2012,Lille,Francia,20,27.6,6,66,5,3,8,5,0,0,15.0,0.0
2011-2012,Lyon,Francia,20,25.9,10,88,10,8,18,10,0,0,15.0,0.0
2011-2012,Manchester City,Inglaterra,20,25.7,6,66,8,5,13,7,1,1,10.0,0.0
2011-2012,Manchester Utd,Inglaterra,24,26.1,6,66,10,6,16,8,2,2,8.0,1.0
2011-2012,Marseille,Francia,22,26.4,10,110,9,5,14,8,1,1,23.0,3.0
2011-2012,Milan,Italia,27,29.1,10,110,16,12,28,14,2,2,25.0,0.0
2011-2012,Napoli,Italia,19,28.4,8,88,13,10,23,12,1,1,21.0,1.0
2011-2012,Olympiacos,Grecia,22,28.1,6,66,8,4,12,8,0,0,10.0,0.0
2011-2012,Oțelul Galați,Rumanía,22,25.8,6,66,3,0,3,2,1,1,15.0,2.0
2011-2012,Porto,Portugal,20,25.1,6,66,6,3,9,5,1,2,19.0,1.0
2011-2012,Real Madrid,España,24,25.8,12,132,34,27,61,32,2,2,24.0,1.0
2011-2012,Shakhtar,Ucrania,20,25.9,6,66,6,4,10,6,0,1,17.0,2.0
2011-2012,Trabzonspor,Turquía,18,27.5,8,66,3,1,4,2,1,1,15.0,0.0
2011-2012,Valencia,España,19,26.0,6,66,12,8,20,11,1,1,11.0,0.0
2011-2012,Viktoria Plzeň,República checa,19,28.5,12,66,4,4,8,4,0,0,16.0,0.0
2011-2012,Villarreal,España,23,26.2,8,66,2,1,3,2,0,0,20.0,0.0
2011-2012,ruZen,Italia,20,28.3,8,88,10,6,16,10,0,1,18.0,1.0
2010-2011,Ajax,Países bajos,17,24.2,10,66,6,4,10,6,0,0,10.0,1.0
2010-2011,Arsenal,Inglaterra,25,24.8,8,88,20,13,33,17,3,4,13.0,2.0
2010-2011,Auxerre,Francia,20,27.3,8,66,3,2,5,3,0,0,8.0,2.0
2010-2011,Barcelona,España,25,26.6,13,143,30,24,54,28,2,3,14.0,1.0
2010-2011,Basel,Suiza,18,25.7,10,66,8,6,14,8,0,0,7.0,1.0
2010-2011,Bayern Munich,Alemania,23,26.4,8,88,17,11,28,16,1,1,17.0,0.0
2010-2011,Benfica,Portugal,19,25.6,6,66,7,6,13,7,0,0,12.0,1.0
2010-2011,Braga,Portugal,21,27.6,10,66,5,4,9,5,0,0,10.0,0.0
2010-2011,Bursaspor,Turquía,21,28.0,6,66,2,2,4,2,0,0,9.0,0.0
2010-2011,CFR Cluj,Rumanía,22,26.5,6,66,6,6,12,6,0,0,12.0,1.0
2010-2011,Chelsea,Inglaterra,25,27.5,10,110,17,10,27,15,2,2,14.0,1.0
2010-2011,FC Copenhagen,Dinamarca,19,26.6,12,88,6,3,9,5,1,1,12.0,0.0
2010-2011,Hapoel Tel Aviv,Israel,19,25.9,12,66,7,5,12,6,1,1,14.0,0.0
2010-2011,Inter,Italia,29,29.0,10,110,18,14,32,17,1,1,17.0,1.0
2010-2011,Lyon,Francia,20,25.5,8,88,12,8,20,11,1,1,15.0,0.0
2010-2011,Manchester Utd,Inglaterra,28,27.7,13,143,18,16,34,17,1,1,14.0,0.0
2010-2011,Marseille,Francia,20,27.0,8,88,12,11,23,12,0,0,11.0,0.0
2010-2011,Milan,Italia,23,29.5,8,88,7,5,12,7,0,0,23.0,0.0
2010-2011,MŠK Žilina,Eslovaquia,19,26.1,12,66,3,2,5,3,0,0,9.0,0.0
2010-2011,Panathinaikos,Grecia,21,28.2,6,66,2,2,4,2,0,0,11.0,1.0
2010-2011,Partizan,Serbia,21,26.1,12,66,2,1,3,1,1,2,11.0,1.0
2010-2011,Rangers,Escocia,19,28.0,6,66,3,3,6,3,0,0,10.0,0.0
2010-2011,Real Madrid,España,26,25.7,12,132,24,20,44,23,1,1,28.0,3.0
2010-2011,Roma,Italia,25,29.7,8,84,12,8,20,10,2,3,14.0,1.0
2010-2011,Rubin Kazan,Rusia,20,26.8,6,66,2,0,2,0,2,2,10.0,0.0
2010-2011,Schalke 04,Alemania,27,25.2,12,132,21,15,36,21,0,0,27.0,2.0
2010-2011,Shakhtar,Ucrania,22,24.9,10,110,19,14,33,18,1,1,24.0,0.0
2010-2011,Spartak Moscow,Rusia,22,25.3,6,66,6,6,12,6,0,0,7.0,2.0
2010-2011,Tottenham,Inglaterra,25,26.6,12,110,17,13,30,15,2,4,9.0,3.0
2010-2011,Twente,Países bajos,21,24.9,6,66,8,2,10,7,1,1,10.0,0.0
2010-2011,Valencia,España,26,27.6,8,88,16,10,26,15,1,1,12.0,0.0
2010-2011,Werr Bremen,Alemania,22,25.9,8,66,6,6,12,6,0,0,9.0,1.0
2009-2010,APOEL FC,Chipre,20,30.1,12,66,3,2,5,3,0,0,12.0,0.0
2009-2010,Arsenal,Inglaterra,29,24.6,12,109,21,16,37,19,2,2,19.0,0.0
2009-2010,Atlético Madrid,España,21,26.4,8,66,3,0,3,3,0,0,12.0,0.0
2009-2010,AZ Alkmaar,Países bajos,19,24.5,6,66,4,4,8,4,0,0,9.0,0.0
2009-2010,Barcelona,España,20,26.5,12,132,20,16,36,20,0,0,19.0,1.0
2009-2010,Bayern Munich,Alemania,22,27.2,13,143,20,12,32,18,2,2,21.0,3.0
2009-2010,Beşiktaş,Turquía,22,28.4,6,66,3,3,6,3,0,0,14.0,0.0
2009-2010,Bordeaux,Francia,23,26.4,10,110,14,12,26,14,0,2,10.0,1.0
2009-2010,Chelsea,Inglaterra,22,28.6,8,86,11,9,20,11,0,0,14.0,1.0
2009-2010,CSKA Moscow,Rusia,20,25.1,10,110,13,12,25,13,0,0,21.0,2.0
2009-2010,Debrecen,Hungría,20,26.6,12,66,5,5,10,5,0,0,7.0,0.0
2009-2010,Dynamo Kyiv,Ucrania,17,25.3,6,66,6,3,9,6,0,0,15.0,0.0
2009-2010,Fiorentina,Italia,23,27.6,10,83,16,13,29,15,1,1,15.0,2.0
2009-2010,Inter,Italia,23,29.5,13,143,17,13,30,17,0,0,30.0,2.0
2009-2010,Juventus,Italia,22,28.7,6,66,4,4,8,4,0,0,11.0,0.0
2009-2010,Liverpool,Inglaterra,24,26.1,6,66,5,3,8,5,0,0,3.0,0.0
2009-2010,Lyon,Francia,20,25.8,14,132,17,12,29,16,1,1,23.0,2.0
2009-2010,Maccabi Haifa,Israel,20,24.9,12,66,0,0,0,0,0,0,13.0,2.0
2009-2010,Manchester Utd,Inglaterra,27,27.3,10,112,20,18,38,20,0,0,11.0,2.0
2009-2010,Marseille,Francia,20,28.2,6,66,9,5,14,9,0,1,10.0,2.0
2009-2010,Milan,Italia,25,29.8,8,88,10,7,17,8,2,2,17.0,0.0
2009-2010,Olympiacos,Grecia,24,28.8,12,88,5,4,9,5,0,0,14.0,2.0
2009-2010,Porto,Portugal,21,25.1,8,86,10,7,17,9,1,1,12.0,2.0
2009-2010,Rangers,Escocia,19,27.6,6,66,3,3,6,3,0,1,11.0,0.0
2009-2010,Real Madrid,España,21,25.4,8,89,16,9,25,15,1,1,22.0,0.0
2009-2010,Rubin Kazan,Rusia,16,27.8,6,60,2,1,3,2,0,0,12.0,0.0
2009-2010,Sevilla,España,25,27.4,8,88,13,11,24,12,1,1,9.0,0.0
2009-2010,Standard Liège,Bélgica,19,23.8,6,66,6,4,10,5,1,1,13.0,1.0
2009-2010,Stuttgart,Alemania,20,26.1,10,84,10,8,18,10,0,0,14.0,0.0
2009-2010,Unirea Urziceni,Rumanía,21,27.8,6,70,5,2,7,5,0,0,15.0,0.0
2009-2010,Wolfsburg,Alemania,17,26.4,6,66,9,7,16,8,1,1,3.0,1.0
2009-2010,Züri,Suiza,18,25.4,10,68,5,3,8,4,1,1,14.0,1.0
2008-2009,Aalborg,Dinamarca,16,26.3,10,62,7,5,12,7,0,0,8.0,1.0
2008-2009,Anorthosis,Chipre,20,29.9,12,64,7,3,10,7,0,0,10.0,0.0
2008-2009,Arsenal,Inglaterra,24,23.9,14,132,17,12,29,13,4,4,20.0,0.0
2008-2009,Atlético Madrid,España,22,27.0,10,88,11,8,19,11,0,0,17.0,0.0
2008-2009,Barcelona,España,23,25.9,15,144,31,27,58,29,2,2,22.0,1.0
2008-2009,Basel,Suiza,21,25.7,10,65,2,2,4,2,0,0,7.0,0.0
2008-2009,BATE Borisov,Bielorrusia,19,24.7,12,68,3,2,5,3,0,0,14.0,1.0
2008-2009,Bayern Munich,Alemania,22,28.0,10,110,24,14,38,22,2,2,17.0,0.0
2008-2009,Bordeaux,Francia,17,27.2,6,57,4,3,7,4,0,0,14.0,1.0
2008-2009,Celtic,Escocia,19,26.3,6,65,4,4,8,4,0,1,8.0,0.0
2008-2009,CFR Cluj,Rumanía,18,26.6,6,66,5,2,7,5,0,0,16.0,1.0
2008-2009,Chelsea,Inglaterra,21,27.5,12,129,20,16,36,20,0,0,30.0,2.0
2008-2009,Dynamo Kyiv,Ucrania,19,24.8,10,66,4,2,6,3,1,1,16.0,1.0
2008-2009,Fenerbahçe,Turquía,20,27.8,10,66,3,0,3,3,0,0,17.0,1.0
2008-2009,Fiorentina,Italia,19,26.7,8,66,5,5,10,5,0,0,13.0,0.0
2008-2009,Inter,Italia,23,28.4,8,87,7,7,14,7,0,0,12.0,0.0
2008-2009,Juventus,Italia,25,28.7,10,88,9,6,15,8,1,2,19.0,1.0
2008-2009,Liverpool,Inglaterra,22,26.1,12,112,20,14,34,16,4,4,17.0,0.0
2008-2009,Lyon,Francia,22,26.3,8,88,16,11,27,16,0,0,22.0,1.0
2008-2009,Manchester Utd,Inglaterra,24,26.9,13,143,18,12,30,18,0,0,14.0,1.0
2008-2009,Marseille,Francia,18,25.9,8,66,5,5,10,5,0,0,6.0,0.0
2008-2009,Panathinaikos,Grecia,22,27.6,12,88,10,4,14,9,1,1,15.0,0.0
2008-2009,Porto,Portugal,22,25.0,10,109,12,9,21,12,0,0,16.0,1.0
2008-2009,PSV Eindhoven,Países bajos,19,26.4,6,63,5,4,9,5,0,0,13.0,0.0
2008-2009,Real Madrid,España,25,26.6,8,88,8,5,13,8,0,0,11.0,0.0
2008-2009,Roma,Italia,23,28.2,8,90,13,10,23,13,0,0,16.0,0.0
2008-2009,Shakhtar,Ucrania,22,24.8,8,66,11,9,20,11,0,0,19.0,0.0
2008-2009,Sporting CP,Portugal,21,26.2,8,88,9,5,14,9,0,0,13.0,1.0
2008-2009,Steaua,Rumanía,20,27.2,8,67,3,3,6,3,0,0,18.0,1.0
2008-2009,Villarreal,España,21,27.3,10,106,13,9,22,12,1,1,21.0,3.0
2008-2009,Werr Bremen,Alemania,21,25.9,6,66,7,5,12,6,1,1,17.0,0.0
2008-2009,ruZen,Italia,16,27.2,6,63,4,3,7,4,0,0,11.0,1.0
2007-2008,Arsenal,Inglaterra,24,24.2,12,110,18,16,34,18,0,0,16.0,0.0
2007-2008,Barcelona,España,24,26.8,12,141,19,13,32,18,1,1,20.0,0.0
2007-2008,Benfica,Portugal,20,26.9,8,66,5,4,9,5,0,0,7.0,1.0
2007-2008,Beşiktaş,Turquía,22,26.5,10,69,3,2,5,3,0,0,4.0,0.0
2007-2008,Celtic,Escocia,23,25.9,10,89,6,5,11,6,0,0,12.0,0.0
2007-2008,Chelsea,Inglaterra,24,28.0,13,146,17,11,28,16,1,1,14.0,1.0
2007-2008,CSKA Moscow,Rusia,22,24.7,6,65,6,3,9,5,1,1,14.0,0.0
2007-2008,Dynamo Kyiv,Ucrania,27,26.9,8,66,4,4,8,4,0,0,6.0,0.0
2007-2008,Fenerbahçe,Turquía,21,27.1,12,110,14,8,22,14,0,0,21.0,1.0
2007-2008,Inter,Italia,24,28.8,8,88,12,9,21,11,1,1,14.0,1.0
2007-2008,Lazio,Italia,21,28.3,8,67,8,5,13,8,0,1,9.0,0.0
2007-2008,Liverpool,Inglaterra,22,26.5,14,130,29,22,51,26,3,3,11.0,0.0
2007-2008,Lyon,Francia,22,27.1,8,88,12,8,20,11,1,1,13.0,0.0
2007-2008,Manchester Utd,Inglaterra,26,26.2,13,144,20,15,35,19,1,1,14.0,0.0
2007-2008,Marseille,Francia,20,25.1,6,66,6,3,9,6,0,0,10.0,0.0
2007-2008,Milan,Italia,23,30.0,8,88,12,9,21,11,1,1,15.0,0.0
2007-2008,Olympiacos,Grecia,23,30.1,8,88,11,6,17,11,0,0,14.0,1.0
2007-2008,Porto,Portugal,22,26.0,8,88,7,5,12,5,2,2,8.0,1.0
2007-2008,PSV Eindhoven,Países bajos,21,25.9,6,68,3,2,5,3,0,0,9.0,1.0
2007-2008,Rangers,Escocia,18,27.4,10,63,7,5,12,6,1,1,14.0,1.0
2007-2008,Real Madrid,España,23,26.2,8,88,15,13,28,15,0,0,12.0,0.0
2007-2008,Roma,Italia,22,27.9,10,110,14,9,23,14,0,0,21.0,0.0
2007-2008,Rosenborg,Noruega,16,27.5,10,69,6,4,10,6,0,0,6.0,0.0
2007-2008,Schalke 04,Alemania,23,25.9,10,110,6,6,12,6,0,0,25.0,0.0
2007-2008,Sevilla,España,24,27.1,10,82,16,10,26,16,0,0,7.0,0.0
2007-2008,Shakhtar,Ucrania,17,25.1,10,66,6,3,9,5,1,1,11.0,0.0
2007-2008,Slavia Prague,República checa,23,26.2,10,65,5,3,8,5,0,0,12.0,0.0
2007-2008,Sporting CP,Portugal,23,24.9,6,65,9,5,14,8,1,1,8.0,0.0
2007-2008,Steaua,Rumanía,21,25.6,10,66,4,3,7,4,0,0,8.0,0.0
2007-2008,Stuttgart,Alemania,21,25.6,6,82,7,4,11,7,0,1,8.0,0.0
2007-2008,Valencia,España,23,27.5,8,66,2,1,3,2,0,0,6.0,1.0
2007-2008,Werr Bremen,Alemania,20,25.6,8,80,8,6,14,7,1,1,6.0,1.0
2006-2007,AEK Athens,Grecia,22,27.2,8,66,6,4,10,6,0,0,13.0,0.0
2006-2007,Anderlecht,Bélgica,17,24.9,6,62,7,6,13,7,0,0,11.0,1.0
2006-2007,Arsenal,Inglaterra,23,25.4,10,83,7,6,13,6,1,1,8.0,0.0
2006-2007,Barcelona,España,21,27.1,8,88,14,10,24,14,0,0,12.0,0.0
2006-2007,Bayern Munich,Alemania,20,27.4,10,109,16,8,24,15,1,1,19.0,2.0
2006-2007,Benfica,Portugal,18,28.1,8,58,6,4,10,6,0,0,6.0,0.0
2006-2007,Bordeaux,Francia,21,26.8,6,66,6,5,11,6,0,0,6.0,1.0
2006-2007,Celtic,Escocia,20,26.9,8,90,8,4,12,7,1,1,15.0,0.0
2006-2007,Chelsea,Inglaterra,22,26.6,12,132,17,14,31,16,1,1,23.0,0.0
2006-2007,CSKA Moscow,Rusia,19,24.4,8,66,4,3,7,3,1,1,15.0,0.0
2006-2007,Dynamo Kyiv,Ucrania,25,25.9,10,66,5,3,8,5,0,0,12.0,0.0
2006-2007,FC Copenhagen,Dinamarca,17,26.5,10,66,5,3,8,5,0,0,6.0,0.0
2006-2007,Galatasaray,Turquía,24,28.0,8,66,7,3,10,7,0,0,11.0,2.0
2006-2007,Hamburger SV,Alemania,24,25.7,8,66,7,3,10,7,0,0,12.0,2.0
2006-2007,Inter,Italia,23,29.1,8,88,7,6,13,7,0,0,14.0,3.0
2006-2007,Levski Sofia,Bulgaria,21,27.7,10,66,1,1,2,1,0,0,7.0,0.0
2006-2007,Lille,Francia,23,25.3,10,88,7,6,13,7,0,0,19.0,1.0
2006-2007,Liverpool,Inglaterra,25,25.9,15,135,19,15,34,19,0,0,19.0,0.0
2006-2007,Lyon,Francia,24,26.9,8,88,12,9,21,12,0,0,17.0,0.0
2006-2007,Manchester Utd,Inglaterra,21,27.4,12,132,22,17,39,21,1,1,21.0,1.0
2006-2007,Milan,Italia,24,29.5,15,144,20,15,35,17,3,3,20.0,2.0
2006-2007,Olympiacos,Grecia,18,30.0,6,63,6,6,12,6,0,0,12.0,0.0
2006-2007,Porto,Portugal,21,24.4,8,87,11,7,18,10,1,1,11.0,0.0
2006-2007,PSV Eindhoven,Países bajos,21,26.1,10,108,8,6,14,8,0,0,9.0,2.0
2006-2007,Real Madrid,España,27,27.4,8,88,17,9,26,14,3,3,12.0,1.0
2006-2007,Roma,Italia,21,27.1,10,111,13,8,21,12,1,1,24.0,0.0
2006-2007,Shakhtar,Ucrania,21,24.3,8,65,6,3,9,6,0,0,18.0,2.0
2006-2007,Spartak Moscow,Rusia,20,26.0,10,63,7,6,13,7,0,0,6.0,0.0
2006-2007,Sporting CP,Portugal,21,25.1,6,66,3,3,6,3,0,0,13.0,0.0
2006-2007,Steaua,Rumanía,20,25.9,10,66,7,5,12,7,0,0,14.0,0.0
2006-2007,Valencia,España,30,27.0,12,110,15,9,24,15,0,0,21.0,0.0
2006-2007,Werr Bremen,Alemania,19,25.5,6,66,5,3,8,5,0,0,12.0,0.0
2005-2006,Ajax,Países bajos,21,24.3,10,87,11,7,18,11,0,0,14.0,1.0
2005-2006,Anderlecht,Bélgica,22,26.7,10,63,1,1,2,1,0,0,4.0,1.0
2005-2006,Arsenal,Inglaterra,25,25.5,13,142,15,9,24,13,2,2,15.0,1.0
2005-2006,Artmedia,Eslovaquia,18,26.5,12,66,5,3,8,5,0,0,12.0,0.0
2005-2006,Barcelona,España,22,26.7,13,143,23,12,35,21,2,3,21.0,0.0
2005-2006,Bayern Munich,Alemania,21,28.2,8,88,12,8,20,12,0,0,13.0,0.0
2005-2006,Benfica,Portugal,24,26.0,10,109,7,4,11,7,0,0,13.0,0.0
2005-2006,Betis,España,21,25.5,8,69,3,3,6,3,0,0,18.0,0.0
2005-2006,Chelsea,Inglaterra,21,26.1,8,89,8,6,14,7,1,1,17.0,1.0
2005-2006,Club Brugge,Bélgica,23,27.1,8,68,6,4,10,6,0,0,8.0,0.0
2005-2006,Fenerbahçe,Turquía,17,25.6,6,66,7,2,9,5,2,2,10.0,3.0
2005-2006,Inter,Italia,26,28.2,12,113,12,10,22,11,1,3,16.0,2.0
2005-2006,Juventus,Italia,21,28.8,10,110,16,10,26,16,0,0,24.0,4.0
2005-2006,Lille,Francia,22,24.8,6,66,1,1,2,1,0,0,13.0,0.0
2005-2006,Liverpool,Inglaterra,21,26.3,14,90,5,4,9,5,0,0,11.0,0.0
2005-2006,Lyon,Francia,24,26.7,10,114,17,10,27,17,0,1,16.0,1.0
2005-2006,Manchester Utd,Inglaterra,18,26.1,8,65,3,1,4,3,0,0,15.0,2.0
2005-2006,Milan,Italia,21,29.5,12,131,20,16,36,19,1,2,18.0,1.0
2005-2006,Olympiacos,Grecia,20,29.8,6,64,6,3,9,6,0,0,10.0,1.0
2005-2006,Panathinaikos,Grecia,20,25.7,8,66,4,3,7,3,1,1,12.0,0.0
2005-2006,Porto,Portugal,21,25.5,6,64,6,5,11,6,0,0,12.0,0.0
2005-2006,PSV Eindhoven,Países bajos,20,26.0,8,88,4,3,7,4,0,0,9.0,2.0
2005-2006,Rangers,Escocia,23,27.0,10,85,9,6,15,9,0,0,14.0,0.0
2005-2006,Rapid Wien,Austria,19,27.8,10,65,3,2,5,3,0,0,8.0,0.0
2005-2006,Real Madrid,España,27,26.6,8,85,9,8,17,9,0,0,15.0,1.0
2005-2006,Rosenborg,Noruega,14,28.1,8,63,5,3,8,5,0,1,2.0,0.0
2005-2006,Schalke 04,Alemania,15,27.2,6,66,13,5,18,11,2,2,13.0,0.0
2005-2006,Sparta Prague,República checa,16,26.7,6,59,2,0,2,2,0,0,4.0,1.0
2005-2006,Thun,Suiza,15,24.8,10,64,4,2,6,4,0,0,11.0,2.0
2005-2006,Udinese,Italia,15,27.4,8,61,9,6,15,7,2,2,11.0,1.0
2005-2006,Villarreal,España,24,27.3,14,143,8,5,13,6,2,3,27.0,0.0
2005-2006,Werr Bremen,Alemania,19,26.9,10,108,14,10,24,12,2,2,14.0,2.0
2004-2005,Ajax,Países bajos,23,23.2,6,66,6,3,9,6,0,1,8.0,0.0
2004-2005,Anderlecht,Bélgica,22,25.9,8,66,4,2,6,4,0,1,8.0,0.0
2004-2005,Arsenal,Inglaterra,22,26.5,8,88,12,7,19,10,2,2,8.0,2.0
2004-2005,Barcelona,España,23,25.6,8,88,13,9,22,11,2,4,7.0,0.0
2004-2005,Bayern Munich,Alemania,23,28.1,10,110,20,12,32,17,3,3,16.0,0.0
2004-2005,Celtic,Escocia,19,28.5,6,66,4,4,8,4,0,0,12.0,0.0
2004-2005,Chelsea,Inglaterra,23,25.3,12,132,20,18,38,20,0,0,19.0,1.0
2004-2005,CSKA Moscow,Rusia,20,23.8,10,66,5,3,8,4,1,3,8.0,1.0
2004-2005,Dynamo Kyiv,Ucrania,19,24.2,8,55,7,3,10,7,0,0,9.0,0.0
2004-2005,Fenerbahçe,Turquía,19,26.2,6,66,8,6,14,8,0,0,8.0,2.0
2004-2005,Inter,Italia,26,28.1,12,99,18,14,32,17,1,2,15.0,1.0
2004-2005,Juventus,Italia,22,28.2,12,110,9,6,15,9,0,0,23.0,1.0
2004-2005,La Coruña,España,21,28.6,8,67,0,0,0,0,0,0,12.0,0.0
2004-2005,Leverkusen,Alemania,21,27.2,10,88,15,8,23,15,0,0,22.0,1.0
2004-2005,Liverpool,Inglaterra,26,26.1,15,143,17,11,28,17,0,1,21.0,0.0
2004-2005,Lyon,Francia,22,25.6,10,110,29,21,50,28,1,1,10.0,0.0
2004-2005,Maccabi Tel Aviv,Israel,19,23.7,10,66,4,1,5,2,2,2,7.0,0.0
2004-2005,Manchester Utd,Inglaterra,27,25.8,10,89,14,9,23,13,1,1,10.0,0.0
2004-2005,Milan,Italia,21,29.4,13,131,20,17,37,20,0,0,15.0,0.0
2004-2005,Monaco,Francia,20,24.9,10,89,10,8,18,10,0,0,10.0,1.0
2004-2005,Olympiacos,Grecia,19,30.1,6,66,5,3,8,5,0,0,15.0,1.0
2004-2005,Panathinaikos,Grecia,22,26.9,6,66,10,4,14,9,1,2,12.0,0.0
2004-2005,Paris S-G,Francia,20,26.7,6,66,3,3,6,3,0,0,8.0,1.0
2004-2005,Porto,Portugal,24,26.2,8,88,6,3,9,6,0,0,20.0,0.0
2004-2005,PSV Eindhoven,Países bajos,20,26.2,14,132,14,12,26,14,0,1,13.0,1.0
2004-2005,Real Madrid,España,18,28.2,10,89,12,8,20,9,3,4,14.0,1.0
2004-2005,Roma,Italia,24,25.0,6,55,4,3,7,4,0,0,11.0,3.0
2004-2005,Rosenborg,Noruega,19,28.7,10,66,6,3,9,6,0,0,3.0,0.0
2004-2005,Shakhtar,Ucrania,20,24.3,10,66,5,4,9,5,0,0,5.0,3.0
2004-2005,Sparta Prague,República checa,19,25.4,10,66,2,2,4,2,0,0,4.0,1.0
2004-2005,Valencia,España,20,27.9,6,66,6,5,11,6,0,0,15.0,2.0
2004-2005,Werr Bremen,Alemania,20,26.8,8,88,14,7,21,12,2,2,18.0,1.0
2003-2004,AEK Athens,Grecia,23,28.4,8,66,1,1,2,1,0,0,10.0,1.0
2003-2004,Ajax,Países bajos,22,23.0,8,66,6,4,10,5,1,1,14.0,1.0
2003-2004,Anderlecht,Bélgica,17,26.0,10,66,4,3,7,4,0,1,12.0,1.0
2003-2004,Arsenal,Inglaterra,18,27.7,10,107,15,9,24,15,0,0,8.0,0.0
2003-2004,Bayern Munich,Alemania,19,28.0,8,91,6,4,10,5,1,1,20.0,1.0
2003-2004,Beşiktaş,Turquía,18,30.1,6,66,5,1,6,3,2,2,11.0,1.0
2003-2004,Celta Vigo,España,21,28.7,10,87,8,5,13,7,1,1,20.0,1.0
2003-2004,Celtic,Escocia,19,29.0,10,66,8,8,16,8,0,1,11.0,0.0
2003-2004,Chelsea,Inglaterra,21,26.2,14,128,14,5,19,14,0,0,17.0,2.0
2003-2004,Club Brugge,Bélgica,21,28.0,8,66,4,4,8,4,0,0,9.0,2.0
2003-2004,Dynamo Kyiv,Ucrania,19,25.4,8,66,8,5,13,8,0,0,7.0,0.0
2003-2004,Galatasaray,Turquía,22,28.2,8,66,6,6,12,6,0,0,13.0,2.0
2003-2004,Inter,Italia,22,27.9,6,66,8,5,13,8,0,0,9.0,0.0
2003-2004,Juventus,Italia,22,28.4,8,89,15,12,27,15,0,0,16.0,0.0
2003-2004,La Coruña,España,22,28.9,14,131,16,5,21,15,1,1,18.0,2.0
2003-2004,Lazio,Italia,21,29.6,8,66,6,2,8,5,1,1,13.0,1.0
2003-2004,Loko Moscow,Rusia,17,27.6,10,66,7,4,11,6,1,1,9.0,1.0
2003-2004,Lyon,Francia,20,25.8,10,110,10,3,13,8,2,2,12.0,1.0
2003-2004,Manchester Utd,Inglaterra,22,26.0,8,85,14,9,23,13,1,1,9.0,1.0
2003-2004,Marseille,Francia,19,25.5,8,66,9,7,16,9,0,0,7.0,0.0
2003-2004,Milan,Italia,24,28.8,10,113,12,2,14,12,0,0,14.0,2.0
2003-2004,Monaco,Francia,20,25.5,13,143,25,8,33,25,0,0,18.0,3.0
2003-2004,Olympiacos,Grecia,20,28.3,6,66,6,5,11,6,0,0,15.0,1.0
2003-2004,Panathinaikos,Grecia,21,27.9,6,66,5,5,10,5,0,0,12.0,1.0
2003-2004,Partizan,Serbia,22,26.5,10,66,3,1,4,3,0,0,6.0,1.0
2003-2004,Porto,Portugal,22,27.5,13,136,16,6,22,15,1,1,25.0,0.0
2003-2004,PSV Eindhoven,Países bajos,19,25.5,6,66,8,4,12,8,0,0,13.0,1.0
2003-2004,Rangers,Escocia,19,27.5,8,66,4,1,5,4,0,0,8.0,0.0
2003-2004,Real Madrid,España,19,26.9,10,106,17,9,26,16,1,1,13.0,0.0
2003-2004,Real Sociedad,España,20,28.7,8,86,7,5,12,6,1,1,11.0,1.0
2003-2004,Sparta Prague,República checa,21,26.9,10,85,6,4,10,6,0,0,5.0,0.0
2003-2004,Stuttgart,Alemania,21,25.1,8,88,8,7,15,8,0,1,8.0,0.0
