Season,Squad,# Pl,Age,Poss,MP,Starts,Min,90s,Gls,Ast,G+A,G-PK,PK,PKatt,CrdY,CrdR
2022-2023,nlAjax,19,26.4,53.2,6,66,540,6.0,11,9,20,10,1,1,15,1
2022-2023,esAtlético Madrid,22,28.6,56.5,6,66,540,6.0,4,3,7,4,0,2,11,0
2022-2023,esBarcelona,26,26.4,64.8,6,66,540,6.0,12,10,22,12,0,0,9,0
2022-2023,deBayern Munich,24,26.6,56.1,10,110,900,10.0,21,19,40,20,1,1,20,1
2022-2023,ptBenfica,24,26.0,52.9,10,110,900,10.0,25,16,41,20,5,5,19,0
2022-2023,sctCeltic,22,26.0,44.2,6,66,540,6.0,3,1,4,3,0,1,7,0
2022-2023,engChelsea,26,26.9,57.3,10,110,900,10.0,12,7,19,10,2,2,24,1
2022-2023,beClub Brugge,25,26.3,45.6,8,88,720,8.0,8,7,15,7,1,2,27,1
2022-2023,hrDinamo Zagreb,20,26.9,46.8,6,66,540,6.0,4,2,6,4,0,0,13,0
2022-2023,deDortmund,26,26.0,47.9,8,88,720,8.0,11,10,21,11,0,0,17,0
2022-2023,deEint Frankfurt,22,26.1,43.3,8,88,720,8.0,7,5,12,6,1,1,18,2
2022-2023,dkFC Copenhagen,25,24.6,37.7,6,66,540,6.0,1,1,2,1,0,0,12,1
2022-2023,itInter,22,28.5,45.6,13,143,"1,170",13.0,19,17,36,18,1,1,25,0
2022-2023,itJuventus,26,28.3,48.3,6,66,540,6.0,9,8,17,9,0,0,14,0
2022-2023,deLeverkusen,20,24.8,51.3,6,66,540,6.0,4,4,8,4,0,2,18,1
2022-2023,engLiverpool,25,27.5,54.9,8,88,720,8.0,19,15,34,18,1,1,10,0
2022-2023,ilMaccabi Haifa,20,28.1,43.3,6,66,540,6.0,7,6,13,6,1,1,14,0
2022-2023,engManchester City,23,27.1,59.8,13,143,"1,170",13.0,31,23,54,29,2,5,21,1
2022-2023,frMarseille,19,27.0,59.2,6,66,540,6.0,8,6,14,7,1,1,10,1
2022-2023,itMilan,23,26.3,48.0,12,132,"1,080",12.0,14,9,23,12,2,3,28,1
2022-2023,itNapoli,22,26.4,56.4,10,110,900,10.0,26,20,46,22,4,8,19,1
2022-2023,frParis S-G,21,27.5,56.8,8,88,720,8.0,15,12,27,14,1,1,14,0
2022-2023,ptPorto,24,26.8,47.5,8,88,720,8.0,12,7,19,9,3,3,22,3
2022-2023,sctRangers,22,28.3,38.5,6,66,540,6.0,2,1,3,1,1,1,10,1
2022-2023,deRB Leipzig,22,26.1,50.0,8,88,720,8.0,13,12,25,13,0,0,8,0
2022-2023,atRB Salzburg,19,22.5,40.0,6,66,540,6.0,5,3,8,4,1,1,11,0
2022-2023,esReal Madrid,22,27.8,53.7,12,132,"1,080",12.0,26,21,47,23,3,3,14,0
2022-2023,esSevilla,24,28.8,50.7,6,66,540,6.0,6,5,11,6,0,0,12,0
2022-2023,uaShakhtar,20,24.3,42.3,6,66,540,6.0,8,7,15,8,0,0,15,0
2022-2023,ptSporting CP,25,25.3,45.3,6,66,540,6.0,8,5,13,8,0,0,17,3
2022-2023,engTottenham,25,27.8,50.6,8,88,720,8.0,8,7,15,7,1,2,20,1
2022-2023,czViktoria Plzeň,22,28.1,29.5,6,66,540,6.0,5,4,9,4,1,1,12,1
2021-2022,nlAjax,21,26.0,61.4,8,88,720,8.0,21,16,37,20,1,1,15,0
2021-2022,itAtalanta,21,28.2,52.0,6,66,540,6.0,12,11,23,12,0,0,9,0
2021-2022,esAtlético Madrid,22,27.9,40.6,10,110,900,10.0,9,8,17,8,1,1,24,4
2021-2022,esBarcelona,23,25.9,57.8,6,66,540,6.0,2,1,3,2,0,0,13,1
2021-2022,deBayern Munich,24,26.9,62.9,10,110,900,10.0,30,23,53,27,3,4,12,0
2021-2022,ptBenfica,24,27.7,38.9,10,110,900,10.0,13,10,23,12,1,1,20,0
2021-2022,trBeşiktaş,26,28.0,44.2,6,66,540,6.0,3,2,5,2,1,1,16,2
2021-2022,engChelsea,24,27.4,61.0,10,110,930,10.3,21,15,36,19,2,2,14,0
2021-2022,beClub Brugge,21,26.2,38.8,6,66,540,6.0,5,5,10,5,0,0,11,0
2021-2022,deDortmund,23,26.2,51.8,6,66,540,6.0,10,8,18,8,2,2,8,2
2021-2022,uaDynamo Kyiv,23,25.5,41.2,6,66,540,6.0,1,1,2,1,0,0,10,0
2021-2022,itInter,22,29.0,49.1,8,88,720,8.0,9,6,15,9,0,0,12,2
2021-2022,itJuventus,28,27.3,51.5,8,88,720,8.0,11,6,17,9,2,2,10,0
2021-2022,frLille,23,26.4,46.8,8,88,720,8.0,8,4,12,6,2,2,26,0
2021-2022,engLiverpool,28,27.3,61.8,13,143,"1,170",13.0,28,21,49,27,1,2,15,0
2021-2022,seMalmö,21,28.4,38.0,6,66,540,6.0,1,1,2,1,0,0,14,1
2021-2022,engManchester City,26,27.2,60.1,12,132,"1,110",12.3,28,23,51,26,2,2,22,1
2021-2022,engManchester Utd,31,27.2,53.9,8,88,720,8.0,12,11,23,12,0,0,17,1
2021-2022,itMilan,23,26.0,46.8,6,66,540,6.0,5,4,9,5,0,0,17,1
2021-2022,frParis S-G,21,27.3,54.9,8,88,720,8.0,15,8,23,13,2,4,21,0
2021-2022,ptPorto,22,26.3,47.8,6,66,540,6.0,4,3,7,3,1,1,17,3
2021-2022,deRB Leipzig,23,25.0,49.0,6,66,540,6.0,15,13,28,13,2,3,13,1
2021-2022,atRB Salzburg,21,22.9,44.4,8,88,720,8.0,10,6,16,7,3,5,16,0
2021-2022,esReal Madrid,25,28.0,51.1,13,143,"1,230",13.7,28,21,49,25,3,3,25,0
2021-2022,esSevilla,22,28.9,60.5,6,66,540,6.0,5,3,8,3,2,2,20,2
2021-2022,uaShakhtar,25,25.2,58.8,6,66,540,6.0,2,2,4,2,0,0,5,0
2021-2022,mdSheriff Tiraspol,19,26.0,29.8,6,66,540,6.0,7,5,12,7,0,0,13,0
2021-2022,ptSporting CP,27,26.7,41.4,8,88,720,8.0,14,10,24,12,2,3,21,0
2021-2022,esVillarreal,25,28.0,43.2,12,132,"1,080",12.0,20,16,36,18,2,2,26,2
2021-2022,deWolfsburg,21,26.1,43.2,6,66,540,6.0,5,4,9,5,0,0,25,2
2021-2022,chYoung Boys,24,25.5,50.0,6,66,540,6.0,7,4,11,7,0,0,11,0
2021-2022,ruZenit,21,27.9,45.7,6,66,540,6.0,9,6,15,8,1,2,9,1
2020-2021,nlAjax,21,24.7,56.0,6,66,540,6.0,7,5,12,6,1,1,11,1
2020-2021,itAtalanta,25,27.5,46.5,8,88,720,8.0,11,10,21,11,0,0,11,1
2020-2021,esAtlético Madrid,20,27.0,49.1,8,88,720,8.0,7,6,13,7,0,0,17,1
2020-2021,esBarcelona,27,26.0,62.1,8,88,720,8.0,18,12,30,12,6,7,12,1
2020-2021,trBaşakşehir,21,29.5,42.8,6,66,540,6.0,7,5,12,7,0,0,18,0
2020-2021,deBayern Munich,26,27.0,59.6,10,110,900,10.0,25,18,43,22,3,3,20,1
2020-2021,engChelsea,24,26.2,51.8,13,143,"1,170",13.0,23,16,39,18,5,6,20,0
2020-2021,beClub Brugge,22,25.8,50.2,6,66,540,6.0,8,4,12,6,2,2,10,1
2020-2021,deDortmund,26,25.8,49.5,10,110,900,10.0,19,11,30,17,2,2,9,0
2020-2021,uaDynamo Kyiv,22,24.4,42.5,6,66,540,6.0,4,1,5,3,1,1,9,1
2020-2021,huFerencváros,20,27.8,44.2,6,66,540,6.0,5,3,8,4,1,1,16,0
2020-2021,itInter,21,28.3,50.3,6,66,540,6.0,7,6,13,7,0,0,22,1
2020-2021,itJuventus,22,27.6,55.1,8,88,750,8.3,17,14,31,15,2,2,22,1
2020-2021,ruKrasnodar,23,27.8,37.5,6,66,540,6.0,6,4,10,5,1,1,10,0
2020-2021,itLazio,25,29.0,44.8,8,88,720,8.0,12,8,20,9,3,3,23,0
2020-2021,engLiverpool,29,26.0,52.0,10,110,900,10.0,14,10,24,13,1,1,17,0
2020-2021,ruLoko Moscow,22,28.5,38.8,6,66,540,6.0,5,3,8,3,2,2,12,0
2020-2021,deM'Gladbach,21,27.0,42.0,8,88,720,8.0,15,9,24,13,2,2,12,0
2020-2021,engManchester City,25,26.1,60.2,13,143,"1,170",13.0,24,18,42,22,2,2,18,0
2020-2021,engManchester Utd,23,25.7,51.0,6,66,540,6.0,14,7,21,10,4,4,13,1
2020-2021,frMarseille,20,27.5,50.0,6,66,540,6.0,2,0,2,0,2,3,15,1
2020-2021,dkMidtjylland,22,25.5,42.3,6,66,540,6.0,4,2,6,2,2,2,12,1
2020-2021,grOlympiacos,21,28.7,49.0,6,66,540,6.0,2,2,4,2,0,0,11,1
2020-2021,frParis S-G,23,27.3,48.3,12,132,"1,080",12.0,21,16,37,18,3,4,31,4
2020-2021,ptPorto,26,27.0,39.8,10,110,930,10.3,15,6,21,11,4,4,23,2
2020-2021,deRB Leipzig,20,24.8,52.4,8,88,720,8.0,11,10,21,10,1,1,21,0
2020-2021,atRB Salzburg,19,24.9,48.8,6,66,540,6.0,9,6,15,9,0,0,11,0
2020-2021,esReal Madrid,25,27.9,57.6,12,132,"1,080",12.0,18,13,31,16,2,2,24,0
2020-2021,frRennes,26,25.7,49.5,6,66,540,6.0,3,1,4,1,2,2,17,1
2020-2021,esSevilla,25,27.9,60.3,8,88,720,8.0,13,8,21,12,1,1,20,1
2020-2021,uaShakhtar,23,24.7,45.3,6,66,540,6.0,4,3,7,4,0,0,7,0
2020-2021,ruZenit,21,27.8,46.2,6,66,540,6.0,3,3,6,3,0,0,13,0
2019-2020,nlAjax,19,24.9,54.5,6,66,540,6.0,10,10,20,10,0,0,20,2
2019-2020,itAtalanta,23,27.4,48.3,9,99,810,9.0,17,9,26,13,4,5,25,0
2019-2020,esAtlético Madrid,21,26.2,45.1,9,99,840,9.3,13,9,22,11,2,3,16,0
2019-2020,esBarcelona,24,27.6,57.0,9,99,810,9.0,13,10,23,12,1,1,25,1
2019-2020,deBayern Munich,20,27.0,63.8,11,121,990,11.0,43,37,80,41,2,2,13,0
2019-2020,ptBenfica,23,24.9,48.5,6,66,540,6.0,9,5,14,8,1,1,8,0
2019-2020,engChelsea,22,25.5,51.4,8,88,720,8.0,12,7,19,10,2,3,14,1
2019-2020,beClub Brugge,22,25.4,41.5,6,66,540,6.0,4,3,7,4,0,1,17,3
2019-2020,hrDinamo Zagreb,21,25.7,35.2,6,66,540,6.0,10,9,19,9,1,1,16,1
2019-2020,deDortmund,24,25.8,51.8,8,88,720,8.0,10,9,19,10,0,1,14,2
2019-2020,trGalatasaray,20,29.7,46.7,6,66,540,6.0,1,1,2,1,0,0,21,0
2019-2020,beGenk,20,23.5,40.3,6,66,540,6.0,5,4,9,5,0,0,10,0
2019-2020,itInter,20,27.9,41.5,6,66,540,6.0,10,9,19,10,0,1,17,0
2019-2020,itJuventus,23,28.7,59.4,8,88,720,8.0,14,10,24,13,1,1,10,0
2019-2020,deLeverkusen,20,26.7,58.8,6,66,540,6.0,2,2,4,2,0,0,7,1
2019-2020,frLille,21,23.9,42.7,6,66,540,6.0,4,4,8,4,0,0,14,0
2019-2020,engLiverpool,20,27.0,66.6,8,88,750,8.3,15,11,26,15,0,0,9,0
2019-2020,ruLoko Moscow,20,28.6,32.3,6,66,540,6.0,4,2,6,4,0,0,12,0
2019-2020,frLyon,24,25.0,44.9,10,110,900,10.0,14,9,23,12,2,2,22,0
2019-2020,engManchester City,23,26.9,62.4,9,99,810,9.0,21,18,39,19,2,3,15,2
2019-2020,itNapoli,24,27.1,47.5,8,88,720,8.0,13,6,19,9,4,4,14,0
2019-2020,grOlympiacos,17,26.2,45.0,6,66,540,6.0,8,5,13,6,2,2,14,1
2019-2020,frParis S-G,24,27.4,53.2,11,121,990,11.0,25,20,45,24,1,1,29,0
2019-2020,deRB Leipzig,25,24.2,57.1,10,110,900,10.0,16,10,26,12,4,4,20,0
2019-2020,atRB Salzburg,21,24.1,44.8,6,66,540,6.0,16,13,29,14,2,2,8,0
2019-2020,esReal Madrid,25,27.3,54.8,8,88,720,8.0,16,14,30,15,1,1,13,1
2019-2020,rsRed Star,19,27.5,36.5,6,66,540,6.0,3,2,5,3,0,1,14,0
2019-2020,uaShakhtar,18,28.4,49.8,6,66,540,6.0,8,6,14,7,1,1,11,2
2019-2020,czSlavia Prague,20,26.9,48.7,6,66,540,6.0,4,3,7,3,1,1,16,0
2019-2020,engTottenham,28,26.2,50.0,8,88,720,8.0,18,15,33,16,2,2,14,0
2019-2020,esValencia,23,27.2,48.5,8,88,720,8.0,12,9,21,11,1,3,19,2
2019-2020,ruZenit,19,28.1,39.5,6,66,540,6.0,6,5,11,6,0,0,17,1
2018-2019,grAEK Athens,20,26.0,40.8,6,66,540,6.0,2,2,4,2,0,0,13,2
2018-2019,nlAjax,22,24.3,52.9,12,132,"1,080",12.0,22,17,39,20,2,2,28,1
2018-2019,esAtlético Madrid,21,26.4,48.9,8,88,720,8.0,11,8,19,11,0,0,23,1
2018-2019,esBarcelona,23,27.7,61.4,12,132,"1,080",12.0,25,18,43,24,1,1,20,1
2018-2019,deBayern Munich,20,28.3,56.9,8,88,720,8.0,15,9,24,13,2,2,12,1
2018-2019,ptBenfica,20,25.5,44.3,6,66,540,6.0,6,3,9,6,0,0,14,1
2018-2019,beClub Brugge,25,24.9,40.2,6,66,540,6.0,6,3,9,5,1,1,8,0
2018-2019,ruCSKA Moscow,22,23.9,44.7,6,66,540,6.0,8,5,13,6,2,2,14,2
2018-2019,deDortmund,24,25.0,60.6,8,88,720,8.0,10,8,18,10,0,1,11,0
2018-2019,trGalatasaray,21,28.4,53.5,6,66,540,6.0,5,2,7,3,2,3,14,1
2018-2019,deHoffenheim,25,25.6,45.0,6,66,540,6.0,11,7,18,10,1,1,13,2
2018-2019,itInter,17,28.1,47.7,6,66,540,6.0,6,4,10,6,0,0,15,0
2018-2019,itJuventus,22,28.4,55.2,10,110,900,10.0,14,11,25,11,3,3,16,1
2018-2019,engLiverpool,20,26.1,51.6,13,143,"1,170",13.0,24,17,41,20,4,5,21,0
2018-2019,ruLoko Moscow,19,29.0,45.8,6,66,540,6.0,3,2,5,3,0,1,16,1
2018-2019,frLyon,21,24.4,43.6,8,88,720,8.0,13,9,22,13,0,0,13,0
2018-2019,engManchester City,21,26.7,63.0,10,110,900,10.0,30,20,50,27,3,4,16,1
2018-2019,engManchester Utd,26,26.2,45.6,10,110,900,10.0,9,5,14,7,2,2,20,1
2018-2019,frMonaco,29,25.0,45.0,6,66,540,6.0,2,1,3,2,0,1,13,0
2018-2019,itNapoli,18,28.2,56.3,6,66,540,6.0,7,5,12,6,1,1,13,0
2018-2019,frParis S-G,20,27.0,58.5,8,88,720,8.0,19,14,33,19,0,0,18,0
2018-2019,ptPorto,25,27.9,53.0,10,110,930,10.3,20,15,35,16,4,5,20,0
2018-2019,nlPSV Eindhoven,18,24.4,31.8,6,66,540,6.0,6,5,11,6,0,0,14,0
2018-2019,esReal Madrid,24,27.0,62.1,8,88,720,8.0,15,12,27,15,0,0,13,1
2018-2019,rsRed Star,20,26.8,30.5,6,66,540,6.0,5,3,8,5,0,0,17,0
2018-2019,itRoma,24,27.4,49.3,8,88,750,8.3,14,12,26,13,1,1,12,1
2018-2019,deSchalke 04,27,26.2,42.3,8,88,720,8.0,8,4,12,5,3,3,16,0
2018-2019,uaShakhtar,20,27.5,49.2,6,66,540,6.0,8,8,16,8,0,0,10,0
2018-2019,engTottenham,24,27.0,52.5,13,143,"1,170",13.0,20,17,37,20,0,0,23,1
2018-2019,esValencia,22,25.9,50.3,6,66,540,6.0,5,2,7,5,0,1,20,0
2018-2019,czViktoria Plzeň,21,29.6,38.8,6,66,540,6.0,7,6,13,7,0,1,10,0
2018-2019,chYoung Boys,20,26.1,41.3,6,66,540,6.0,4,1,5,2,2,2,15,2
2017-2018,beAnderlecht,20,26.1,42.5,6,66,540,6.0,1,1,2,1,0,0,,
2017-2018,cyAPOEL FC,21,29.7,31.7,6,66,540,6.0,2,1,3,2,0,0,,
2017-2018,esAtlético Madrid,20,27.0,51.8,6,66,540,6.0,5,4,9,4,1,1,,
2017-2018,esBarcelona,22,27.8,64.2,10,110,900,10.0,12,11,23,12,0,0,,
2017-2018,chBasel,21,25.4,35.9,8,88,720,8.0,13,6,19,12,1,1,,
2017-2018,deBayern Munich,22,27.5,58.8,12,132,"1,080",12.0,24,17,41,23,1,1,,
2017-2018,ptBenfica,25,26.8,56.8,6,66,540,6.0,1,1,2,1,0,0,,
2017-2018,trBeşiktaş,23,30.2,47.8,8,88,720,8.0,12,8,20,10,2,2,,
2017-2018,sctCeltic,20,26.1,43.0,6,66,540,6.0,5,4,9,5,0,0,,
2017-2018,engChelsea,19,26.9,45.9,8,88,720,8.0,15,9,24,13,2,2,,
2017-2018,ruCSKA Moscow,20,28.1,43.5,6,66,540,6.0,7,4,11,6,1,1,,
2017-2018,deDortmund,22,26.2,58.3,6,66,540,6.0,7,6,13,7,0,0,,
2017-2018,nlFeyenoord,23,25.1,39.0,6,66,540,6.0,5,4,9,5,0,1,,
2017-2018,itJuventus,23,29.5,49.4,10,110,900,10.0,14,9,23,13,1,2,,
2017-2018,engLiverpool,24,25.6,50.0,13,143,"1,170",13.0,41,35,76,40,1,3,,
2017-2018,engManchester City,25,25.9,65.8,10,110,900,10.0,20,16,36,19,1,2,,
2017-2018,engManchester Utd,25,26.5,56.9,8,88,720,8.0,12,7,19,10,2,3,,
2017-2018,frMonaco,23,26.0,47.2,6,66,540,6.0,6,4,10,5,1,1,,
2017-2018,itNapoli,20,27.9,54.7,6,66,540,6.0,11,6,17,8,3,4,,
2017-2018,siNK Maribor,17,28.5,33.8,6,66,540,6.0,3,3,6,3,0,0,,
2017-2018,grOlympiacos,22,26.9,36.8,6,66,540,6.0,4,3,7,4,0,0,,
2017-2018,frParis S-G,19,26.2,53.3,8,88,720,8.0,26,18,44,25,1,1,,
2017-2018,ptPorto,25,26.6,45.1,8,88,720,8.0,14,13,27,14,0,0,,
2017-2018,azQarabağ FK,20,28.4,44.0,6,66,540,6.0,2,2,4,2,0,0,,
2017-2018,deRB Leipzig,19,23.9,55.8,6,66,540,6.0,9,5,14,8,1,1,,
2017-2018,esReal Madrid,23,27.8,57.4,13,143,"1,170",13.0,33,19,52,29,4,4,,
2017-2018,itRoma,20,28.0,50.9,12,132,"1,080",12.0,20,15,35,17,3,3,,
2017-2018,esSevilla,22,27.2,57.8,10,110,900,10.0,15,11,26,13,2,2,,
2017-2018,uaShakhtar,20,27.6,47.5,8,88,720,8.0,11,7,18,11,0,0,,
2017-2018,ruSpartak Moscow,20,27.9,46.2,6,66,540,6.0,9,7,16,9,0,0,,
2017-2018,ptSporting CP,21,26.6,41.3,6,66,540,6.0,7,7,14,7,0,0,,
2017-2018,engTottenham,26,25.6,49.9,8,88,720,8.0,17,15,32,17,0,0,,
2016-2017,engArsenal,21,26.3,48.5,8,88,720,8.0,19,13,32,18,1,2,0,1
2016-2017,esAtlético Madrid,20,26.6,48.3,12,132,"1,080",12.0,15,9,24,12,3,4,0,0
2016-2017,esBarcelona,23,27.0,64.8,10,110,900,10.0,25,17,42,22,3,4,0,1
2016-2017,chBasel,18,27.0,41.8,6,66,540,6.0,3,2,5,3,0,0,0,1
2016-2017,deBayern Munich,21,28.3,66.7,10,110,930,10.3,26,13,39,22,4,5,0,2
2016-2017,ptBenfica,25,25.5,44.3,8,88,720,8.0,11,6,17,9,2,2,0,0
2016-2017,trBeşiktaş,21,29.2,48.5,6,66,540,6.0,9,3,12,7,2,2,0,1
2016-2017,sctCeltic,22,26.5,42.3,6,66,540,6.0,4,2,6,3,1,2,0,0
2016-2017,beClub Brugge,21,26.8,48.3,6,66,540,6.0,2,2,4,2,0,0,0,0
2016-2017,ruCSKA Moscow,19,27.9,39.0,6,66,540,6.0,5,4,9,4,1,1,0,0
2016-2017,hrDinamo Zagreb,24,24.4,31.3,6,66,540,6.0,0,0,0,0,0,0,0,1
2016-2017,deDortmund,25,25.1,62.4,10,110,900,10.0,27,21,48,26,1,2,0,0
2016-2017,uaDynamo Kyiv,24,26.1,50.3,6,66,540,6.0,8,5,13,7,1,2,0,1
2016-2017,dkFC Copenhagen,19,25.5,53.7,6,66,540,6.0,5,5,10,5,0,1,0,1
2016-2017,itJuventus,25,29.9,55.3,13,144,"1,170",13.0,21,10,31,18,3,3,0,2
2016-2017,plLegia Warsaw,22,28.0,37.0,6,66,540,6.0,9,8,17,8,1,1,0,1
2016-2017,engLeicester City,26,28.0,39.5,10,110,900,10.0,11,5,16,9,2,2,0,0
2016-2017,deLeverkusen,26,24.6,50.5,8,88,720,8.0,8,5,13,8,0,1,0,0
2016-2017,bgLudogorets,19,28.5,44.2,6,66,540,6.0,6,4,10,6,0,1,0,0
2016-2017,frLyon,21,25.3,51.5,6,66,540,6.0,5,5,10,5,0,1,0,0
2016-2017,deM'Gladbach,19,25.5,39.0,6,66,540,6.0,5,4,9,5,0,0,0,1
2016-2017,engManchester City,22,28.1,56.5,8,88,720,8.0,18,14,32,17,1,1,0,1
2016-2017,frMonaco,23,25.3,44.6,12,132,"1,080",12.0,21,14,35,21,0,3,0,1
2016-2017,itNapoli,21,26.7,54.4,8,88,720,8.0,13,9,22,11,2,3,0,0
2016-2017,frParis S-G,24,26.6,54.8,8,88,720,8.0,17,14,31,16,1,1,0,1
2016-2017,ptPorto,23,26.0,49.5,8,88,720,8.0,9,7,16,7,2,2,0,1
2016-2017,nlPSV Eindhoven,20,24.9,43.7,6,66,540,6.0,4,2,6,4,0,2,0,0
2016-2017,esReal Madrid,23,27.4,53.7,13,143,"1,200",13.3,34,30,64,34,0,0,0,0
2016-2017,ruRostov,18,29.0,32.5,6,66,540,6.0,6,4,10,5,1,1,0,0
2016-2017,esSevilla,22,27.4,60.5,8,88,720,8.0,9,8,17,9,0,3,0,2
2016-2017,ptSporting CP,21,26.2,48.7,6,66,540,6.0,5,2,7,4,1,1,0,1
2016-2017,engTottenham,21,24.9,63.5,6,66,540,6.0,5,5,10,4,1,1,0,0
2015-2016,engArsenal,24,27.2,45.4,8,88,720,8.0,13,12,25,12,1,1,,
2015-2016,esAtlético Madrid,23,26.3,46.3,13,143,"1,230",13.7,16,13,29,15,1,1,,
2015-2016,esBarcelona,25,27.1,65.3,10,112,900,10.0,22,17,39,20,2,2,,
2015-2016,byBATE Borisov,20,26.2,38.5,12,66,540,6.0,5,5,10,5,0,0,,
2015-2016,deBayern Munich,23,26.8,67.4,12,132,"1,110",12.3,30,21,51,29,1,0,,
2015-2016,ptBenfica,25,26.6,49.8,10,110,900,10.0,15,12,27,15,0,0,,
2015-2016,engChelsea,21,26.6,49.5,8,88,720,8.0,13,7,20,12,1,2,,
2015-2016,ruCSKA Moscow,19,28.0,39.2,10,66,540,6.0,5,3,8,2,3,4,,
2015-2016,hrDinamo Zagreb,20,26.3,41.8,12,66,540,6.0,3,2,5,3,0,0,,
2015-2016,uaDynamo Kyiv,21,27.2,52.3,8,88,720,8.0,9,4,13,8,1,1,,
2015-2016,kzFC Astana,21,26.9,43.0,12,66,540,6.0,3,3,6,3,0,0,,
2015-2016,trGalatasaray,19,29.2,49.5,6,66,540,6.0,5,4,9,4,1,1,,
2015-2016,beGent,18,25.9,52.0,8,88,720,8.0,10,7,17,9,1,1,,
2015-2016,itJuventus,20,28.7,43.0,8,88,750,8.3,10,7,17,10,0,0,,
2015-2016,deLeverkusen,18,24.1,52.7,8,66,540,6.0,13,9,22,11,2,2,,
2015-2016,frLyon,21,25.9,51.5,6,66,540,6.0,5,5,10,5,0,1,,
2015-2016,deM'Gladbach,21,25.4,48.3,6,66,540,6.0,8,8,16,8,0,1,,
2015-2016,ilMaccabi Tel Aviv,20,26.8,43.0,12,66,540,6.0,1,0,1,0,1,1,,
2015-2016,seMalmö,19,26.8,34.8,12,66,540,6.0,1,1,2,1,0,2,,
2015-2016,engManchester City,22,28.4,47.8,12,132,"1,080",12.0,16,13,29,15,1,1,,
2015-2016,engManchester Utd,23,25.6,60.5,8,66,540,6.0,6,5,11,5,1,1,,
2015-2016,grOlympiacos,18,25.9,42.8,6,66,540,6.0,5,5,10,5,0,1,,
2015-2016,frParis S-G,21,27.9,59.8,10,110,900,10.0,17,15,32,17,0,1,,
2015-2016,ptPorto,18,25.9,52.7,6,66,540,6.0,9,7,16,9,0,0,,
2015-2016,nlPSV Eindhoven,22,24.1,48.5,8,88,750,8.3,8,8,16,8,0,1,,
2015-2016,esReal Madrid,22,26.7,53.9,13,143,"1,200",13.3,27,17,44,25,2,0,,
2015-2016,itRoma,24,26.0,43.8,8,88,720,8.0,11,8,19,10,1,2,,
2015-2016,esSevilla,19,27.0,53.5,6,66,540,6.0,8,4,12,5,3,4,,
2015-2016,uaShakhtar,22,27.5,55.2,10,66,540,6.0,7,4,11,5,2,2,,
2015-2016,esValencia,22,24.6,51.7,8,66,540,6.0,3,2,5,3,0,0,,
2015-2016,deWolfsburg,22,27.0,48.3,10,110,900,10.0,14,10,24,13,1,1,,
2015-2016,ruZenit,24,28.4,45.6,8,88,720,8.0,14,13,27,14,0,0,,
2014-2015,nlAjax,19,23.6,54.2,6,66,540,6.0,8,6,14,7,1,1,0,0
2014-2015,beAnderlecht,21,23.7,44.3,6,66,540,6.0,8,4,12,7,1,1,0,0
2014-2015,cyAPOEL FC,21,28.9,32.7,10,66,540,6.0,1,0,1,0,1,1,0,0
2014-2015,engArsenal,29,25.4,54.3,10,88,720,8.0,18,9,27,17,1,1,0,0
2014-2015,esAthletic Club,20,26.9,48.2,8,66,540,6.0,5,5,10,5,0,0,0,0
2014-2015,esAtlético Madrid,23,27.4,44.7,10,110,930,10.3,15,10,25,15,0,0,0,0
2014-2015,esBarcelona,22,26.8,60.2,13,143,"1,170",13.0,31,26,57,31,0,1,0,0
2014-2015,chBasel,23,25.1,45.9,8,88,720,8.0,8,6,14,8,0,0,0,0
2014-2015,byBATE Borisov,20,25.3,38.3,12,66,540,6.0,2,1,3,2,0,0,0,0
2014-2015,deBayern Munich,24,26.7,60.3,12,132,"1,080",12.0,33,23,56,29,4,4,0,0
2014-2015,ptBenfica,24,27.5,50.3,6,66,540,6.0,2,2,4,2,0,0,0,0
2014-2015,engChelsea,24,27.1,53.8,8,88,750,8.3,18,12,30,14,4,5,0,0
2014-2015,ruCSKA Moscow,18,27.0,36.7,6,66,540,6.0,6,4,10,5,1,1,0,0
2014-2015,deDortmund,24,26.5,51.9,8,88,720,8.0,14,12,26,14,0,0,0,0
2014-2015,trGalatasaray,22,27.7,51.5,6,66,540,6.0,4,2,6,3,1,1,0,0
2014-2015,itJuventus,24,29.3,54.0,13,143,"1,170",13.0,16,11,27,14,2,3,0,0
2014-2015,deLeverkusen,21,25.2,51.8,10,88,750,8.3,8,7,15,7,1,1,0,0
2014-2015,engLiverpool,21,25.7,49.2,6,66,540,6.0,5,1,6,4,1,1,0,0
2014-2015,bgLudogorets,19,27.4,48.5,12,66,540,6.0,5,4,9,5,0,0,0,0
2014-2015,seMalmö,17,25.1,43.0,12,66,540,6.0,4,2,6,4,0,0,0,0
2014-2015,engManchester City,20,28.7,49.8,8,88,720,8.0,10,4,14,8,2,3,0,0
2014-2015,frMonaco,22,25.9,46.1,10,110,900,10.0,7,7,14,7,0,0,0,0
2014-2015,siNK Maribor,17,27.3,41.5,12,66,540,6.0,3,1,4,3,0,1,0,0
2014-2015,grOlympiacos,19,26.7,47.7,6,66,540,6.0,10,8,18,10,0,0,0,0
2014-2015,frParis S-G,19,27.2,47.7,10,110,930,10.3,13,11,24,13,0,0,0,0
2014-2015,ptPorto,23,24.4,56.3,12,110,900,10.0,25,12,37,22,3,5,0,0
2014-2015,esReal Madrid,23,26.4,56.1,12,132,"1,080",12.0,23,19,42,20,3,4,0,0
2014-2015,itRoma,20,28.3,46.8,6,66,540,6.0,7,5,12,7,0,0,0,0
2014-2015,deSchalke 04,26,25.6,51.4,8,88,720,8.0,12,8,20,11,1,1,0,0
2014-2015,uaShakhtar,20,27.0,49.1,8,88,720,8.0,15,11,26,12,3,3,0,0
2014-2015,ptSporting CP,19,24.1,49.2,6,66,540,6.0,12,5,17,9,3,3,0,0
2014-2015,ruZenit,18,27.6,52.8,10,66,540,6.0,4,4,8,4,0,0,0,0
2013-2014,nlAjax,21,23.5,,6,66,,,5,3,8,5,0,1,0,0
2013-2014,beAnderlecht,21,23.3,,6,66,,,4,4,8,4,0,1,0,0
2013-2014,engArsenal,24,26.9,,10,88,,,9,8,17,9,0,2,0,0
2013-2014,esAtlético Madrid,24,26.7,,13,143,,,26,18,44,25,1,2,0,0
2013-2014,atAustria Wien,19,26.1,,10,66,,,5,4,9,5,0,0,0,0
2013-2014,esBarcelona,24,27.6,,10,110,,,21,16,37,18,3,3,0,0
2013-2014,chBasel,19,25.2,,10,66,,,5,6,11,5,0,0,0,0
2013-2014,deBayern Munich,22,26.5,,12,132,,,24,20,44,22,2,4,0,0
2013-2014,ptBenfica,21,27.0,,6,66,,,7,4,11,6,1,1,0,0
2013-2014,sctCeltic,19,25.7,,12,66,,,3,1,4,2,1,1,0,0
2013-2014,engChelsea,22,28.1,,12,132,,,18,14,32,17,1,1,0,0
2013-2014,ruCSKA Moscow,20,26.2,,6,66,,,7,5,12,5,2,2,0,0
2013-2014,deDortmund,23,25.9,,10,110,,,17,11,28,15,2,2,0,0
2013-2014,dkFC Copenhagen,19,27.5,,6,66,,,4,3,7,4,0,0,0,0
2013-2014,trGalatasaray,23,28.3,,8,88,,,9,8,17,9,0,0,0,0
2013-2014,itJuventus,21,28.3,,6,66,,,9,5,14,5,4,4,0,0
2013-2014,deLeverkusen,21,25.4,,8,88,,,10,5,15,9,1,2,0,0
2013-2014,engManchester City,21,27.5,,8,88,,,19,15,34,16,3,3,0,0
2013-2014,engManchester Utd,24,27.7,,10,110,,,15,11,26,14,1,2,0,0
2013-2014,frMarseille,19,26.6,,6,66,,,5,4,9,4,1,1,0,0
2013-2014,itMilan,25,28.4,,10,88,,,7,4,11,6,1,1,0,0
2013-2014,itNapoli,19,27.5,,6,66,,,10,8,18,10,0,0,0,0
2013-2014,grOlympiacos,23,26.4,,8,88,,,12,10,22,11,1,3,0,0
2013-2014,frParis S-G,21,26.8,,10,110,,,24,20,44,23,1,2,0,0
2013-2014,ptPorto,18,26.2,,6,66,,,4,4,8,4,0,1,0,0
2013-2014,esReal Madrid,22,26.5,,13,143,,,41,35,76,39,2,4,0,0
2013-2014,esReal Sociedad,23,26.0,,8,66,,,1,0,1,1,0,1,0,0
2013-2014,deSchalke 04,25,25.0,,10,88,,,8,6,14,8,0,0,0,0
2013-2014,uaShakhtar,17,26.9,,6,66,,,7,4,11,7,0,0,0,0
2013-2014,roSteaua,21,26.5,,12,66,,,2,2,4,2,0,0,0,0
2013-2014,czViktoria Plzeň,18,28.9,,12,66,,,6,6,12,6,0,0,0,0
2013-2014,ruZenit,21,27.4,,12,88,,,8,5,13,7,1,2,0,0
2012-2013,nlAjax,18,24.4,,6,66,,,8,6,14,8,0,0,7,0
2012-2013,beAnderlecht,20,26.3,,10,66,,,4,4,8,4,0,0,17,1
2012-2013,engArsenal,28,25.6,,8,88,,,13,14,27,13,0,0,26,0
2012-2013,esBarcelona,25,26.9,,12,132,,,18,14,32,17,1,1,25,1
2012-2013,byBATE Borisov,19,26.7,,12,66,,,9,7,16,9,0,0,17,1
2012-2013,deBayern Munich,21,26.3,,13,143,,,30,24,54,29,1,2,30,1
2012-2013,ptBenfica,20,25.6,,6,66,,,5,4,9,5,0,1,16,0
2012-2013,ptBraga,20,27.6,,8,66,,,7,4,11,6,1,1,11,1
2012-2013,sctCeltic,19,25.2,,12,88,,,8,5,13,7,1,1,16,0
2012-2013,roCFR Cluj,19,27.4,,10,66,,,8,7,15,8,0,0,9,1
2012-2013,engChelsea,19,26.3,,6,66,,,16,9,25,15,1,2,6,0
2012-2013,hrDinamo Zagreb,19,24.0,,12,66,,,1,0,1,0,1,1,8,0
2012-2013,deDortmund,20,25.0,,13,143,,,23,16,39,21,2,3,13,0
2012-2013,uaDynamo Kyiv,21,25.9,,10,66,,,5,5,10,5,0,0,13,0
2012-2013,trGalatasaray,22,27.6,,10,110,,,14,12,26,14,0,0,26,0
2012-2013,itJuventus,24,28.1,,10,110,,,16,14,30,16,0,0,20,0
2012-2013,frLille,22,27.1,,8,66,,,4,3,7,4,0,0,18,1
2012-2013,esMálaga,24,28.2,,12,110,,,16,14,30,15,1,2,23,0
2012-2013,engManchester City,21,26.3,,6,66,,,7,3,10,5,2,2,15,0
2012-2013,engManchester Utd,28,26.1,,8,88,,,10,7,17,9,1,2,13,0
2012-2013,itMilan,28,27.2,,8,88,,,8,7,15,8,0,0,21,0
2012-2013,frMontpellier,25,26.1,,6,66,,,6,2,8,4,2,2,15,1
2012-2013,dkNordsjælland,19,26.4,,6,66,,,4,3,7,4,0,1,14,0
2012-2013,grOlympiacos,20,27.5,,6,66,,,9,6,15,9,0,0,13,0
2012-2013,frParis S-G,25,26.8,,10,110,,,20,16,36,19,1,1,22,1
2012-2013,ptPorto,19,25.5,,8,88,,,11,9,20,11,0,0,15,1
2012-2013,esReal Madrid,25,26.5,,12,132,,,26,24,50,26,0,0,25,2
2012-2013,deSchalke 04,23,24.8,,8,88,,,13,10,23,12,1,2,17,0
2012-2013,uaShakhtar,18,26.8,,8,88,,,14,10,24,14,0,0,15,0
2012-2013,ruSpartak Moscow,23,26.0,,8,66,,,5,5,10,5,0,0,18,3
2012-2013,esValencia,23,26.5,,8,88,,,14,7,21,11,3,3,21,2
2012-2013,ruZenit,21,28.8,,6,66,,,6,3,9,5,1,1,15,1
2011-2012,nlAjax,20,23.5,,6,66,,,6,4,10,6,0,0,6,0
2011-2012,cyAPOEL FC,23,30.6,,16,110,,,9,7,16,7,2,2,27,1
2011-2012,engArsenal,29,25.4,,10,88,,,10,4,14,9,1,1,16,0
2011-2012,esBarcelona,31,26.7,,12,132,,,33,22,55,28,5,6,17,0
2011-2012,chBasel,20,24.6,,8,88,,,12,8,20,10,2,2,18,1
2011-2012,byBATE Borisov,21,24.9,,12,66,,,2,0,2,1,1,1,8,0
2011-2012,deBayern Munich,21,25.5,,15,143,,,26,15,41,25,1,3,29,1
2011-2012,ptBenfica,22,25.9,,14,110,,,12,8,20,12,0,0,27,2
2011-2012,engChelsea,23,27.7,,13,152,,,27,21,48,25,2,3,31,1
2011-2012,ruCSKA Moscow,23,26.2,,8,88,,,11,10,21,11,0,0,16,1
2011-2012,hrDinamo Zagreb,19,24.3,,12,66,,,3,2,5,3,0,0,18,1
2011-2012,deDortmund,20,24.2,,6,66,,,6,4,10,5,1,1,7,0
2011-2012,beGenk,20,24.9,,10,66,,,2,2,4,2,0,0,9,0
2011-2012,itInter,25,29.8,,8,88,,,10,8,18,9,1,1,16,0
2011-2012,deLeverkusen,21,24.8,,8,88,,,10,6,16,10,0,0,20,0
2011-2012,frLille,20,27.6,,6,66,,,5,3,8,5,0,0,15,0
2011-2012,frLyon,20,25.9,,10,88,,,10,8,18,10,0,0,15,0
2011-2012,engManchester City,20,25.7,,6,66,,,8,5,13,7,1,1,10,0
2011-2012,engManchester Utd,24,26.1,,6,66,,,10,6,16,8,2,2,8,1
2011-2012,frMarseille,22,26.4,,10,110,,,9,5,14,8,1,1,23,3
2011-2012,itMilan,27,29.1,,10,110,,,16,12,28,14,2,2,25,0
2011-2012,itNapoli,19,28.4,,8,88,,,13,10,23,12,1,1,21,1
2011-2012,grOlympiacos,22,28.1,,6,66,,,8,4,12,8,0,0,10,0
2011-2012,roOțelul Galați,22,25.8,,6,66,,,3,0,3,2,1,1,15,2
2011-2012,ptPorto,20,25.1,,6,66,,,6,3,9,5,1,2,19,1
2011-2012,esReal Madrid,24,25.8,,12,132,,,34,27,61,32,2,2,24,1
2011-2012,uaShakhtar,20,25.9,,6,66,,,6,4,10,6,0,1,17,2
2011-2012,trTrabzonspor,18,27.5,,8,66,,,3,1,4,2,1,1,15,0
2011-2012,esValencia,19,26.0,,6,66,,,12,8,20,11,1,1,11,0
2011-2012,czViktoria Plzeň,19,28.5,,12,66,,,4,4,8,4,0,0,16,0
2011-2012,esVillarreal,23,26.2,,8,66,,,2,1,3,2,0,0,20,0
2011-2012,ruZenit,20,28.3,,8,88,,,10,6,16,10,0,1,18,1
2010-2011,nlAjax,17,24.2,,10,66,,,6,4,10,6,0,0,10,1
2010-2011,engArsenal,25,24.8,,8,88,,,20,13,33,17,3,4,13,2
2010-2011,frAuxerre,20,27.3,,8,66,,,3,2,5,3,0,0,8,2
2010-2011,esBarcelona,25,26.6,,13,143,,,30,24,54,28,2,3,14,1
2010-2011,chBasel,18,25.7,,10,66,,,8,6,14,8,0,0,7,1
2010-2011,deBayern Munich,23,26.4,,8,88,,,17,11,28,16,1,1,17,0
2010-2011,ptBenfica,19,25.6,,6,66,,,7,6,13,7,0,0,12,1
2010-2011,ptBraga,21,27.6,,10,66,,,5,4,9,5,0,0,10,0
2010-2011,trBursaspor,21,28.0,,6,66,,,2,2,4,2,0,0,9,0
2010-2011,roCFR Cluj,22,26.5,,6,66,,,6,6,12,6,0,0,12,1
2010-2011,engChelsea,25,27.5,,10,110,,,17,10,27,15,2,2,14,1
2010-2011,dkFC Copenhagen,19,26.6,,12,88,,,6,3,9,5,1,1,12,0
2010-2011,ilHapoel Tel Aviv,19,25.9,,12,66,,,7,5,12,6,1,1,14,0
2010-2011,itInter,29,29.0,,10,110,,,18,14,32,17,1,1,17,1
2010-2011,frLyon,20,25.5,,8,88,,,12,8,20,11,1,1,15,0
2010-2011,engManchester Utd,28,27.7,,13,143,,,18,16,34,17,1,1,14,0
2010-2011,frMarseille,20,27.0,,8,88,,,12,11,23,12,0,0,11,0
2010-2011,itMilan,23,29.5,,8,88,,,7,5,12,7,0,0,23,0
2010-2011,skMŠK Žilina,19,26.1,,12,66,,,3,2,5,3,0,0,9,0
2010-2011,grPanathinaikos,21,28.2,,6,66,,,2,2,4,2,0,0,11,1
2010-2011,rsPartizan,21,26.1,,12,66,,,2,1,3,1,1,2,11,1
2010-2011,sctRangers,19,28.0,,6,66,,,3,3,6,3,0,0,10,0
2010-2011,esReal Madrid,26,25.7,,12,132,,,24,20,44,23,1,1,28,3
2010-2011,itRoma,25,29.7,,8,84,,,12,8,20,10,2,3,14,1
2010-2011,ruRubin Kazan,20,26.8,,6,66,,,2,0,2,0,2,2,10,0
2010-2011,deSchalke 04,27,25.2,,12,132,,,21,15,36,21,0,0,27,2
2010-2011,uaShakhtar,22,24.9,,10,110,,,19,14,33,18,1,1,24,0
2010-2011,ruSpartak Moscow,22,25.3,,6,66,,,6,6,12,6,0,0,7,2
2010-2011,engTottenham,25,26.6,,12,110,,,17,13,30,15,2,4,9,3
2010-2011,nlTwente,21,24.9,,6,66,,,8,2,10,7,1,1,10,0
2010-2011,esValencia,26,27.6,,8,88,,,16,10,26,15,1,1,12,0
2010-2011,deWerder Bremen,22,25.9,,8,66,,,6,6,12,6,0,0,9,1
2009-2010,cyAPOEL FC,20,30.1,,12,66,,,3,2,5,3,0,0,12,0
2009-2010,engArsenal,29,24.6,,12,109,,,21,16,37,19,2,2,19,0
2009-2010,esAtlético Madrid,21,26.4,,8,66,,,3,0,3,3,0,0,12,0
2009-2010,nlAZ Alkmaar,19,24.5,,6,66,,,4,4,8,4,0,0,9,0
2009-2010,esBarcelona,20,26.5,,12,132,,,20,16,36,20,0,0,19,1
2009-2010,deBayern Munich,22,27.2,,13,143,,,20,12,32,18,2,2,21,3
2009-2010,trBeşiktaş,22,28.4,,6,66,,,3,3,6,3,0,0,14,0
2009-2010,frBordeaux,23,26.4,,10,110,,,14,12,26,14,0,2,10,1
2009-2010,engChelsea,22,28.6,,8,86,,,11,9,20,11,0,0,14,1
2009-2010,ruCSKA Moscow,20,25.1,,10,110,,,13,12,25,13,0,0,21,2
2009-2010,huDebrecen,20,26.6,,12,66,,,5,5,10,5,0,0,7,0
2009-2010,uaDynamo Kyiv,17,25.3,,6,66,,,6,3,9,6,0,0,15,0
2009-2010,itFiorentina,23,27.6,,10,83,,,16,13,29,15,1,1,15,2
2009-2010,itInter,23,29.5,,13,143,,,17,13,30,17,0,0,30,2
2009-2010,itJuventus,22,28.7,,6,66,,,4,4,8,4,0,0,11,0
2009-2010,engLiverpool,24,26.1,,6,66,,,5,3,8,5,0,0,3,0
2009-2010,frLyon,20,25.8,,14,132,,,17,12,29,16,1,1,23,2
2009-2010,ilMaccabi Haifa,20,24.9,,12,66,,,0,0,0,0,0,0,13,2
2009-2010,engManchester Utd,27,27.3,,10,112,,,20,18,38,20,0,0,11,2
2009-2010,frMarseille,20,28.2,,6,66,,,9,5,14,9,0,1,10,2
2009-2010,itMilan,25,29.8,,8,88,,,10,7,17,8,2,2,17,0
2009-2010,grOlympiacos,24,28.8,,12,88,,,5,4,9,5,0,0,14,2
2009-2010,ptPorto,21,25.1,,8,86,,,10,7,17,9,1,1,12,2
2009-2010,sctRangers,19,27.6,,6,66,,,3,3,6,3,0,1,11,0
2009-2010,esReal Madrid,21,25.4,,8,89,,,16,9,25,15,1,1,22,0
2009-2010,ruRubin Kazan,16,27.8,,6,60,,,2,1,3,2,0,0,12,0
2009-2010,esSevilla,25,27.4,,8,88,,,13,11,24,12,1,1,9,0
2009-2010,beStandard Liège,19,23.8,,6,66,,,6,4,10,5,1,1,13,1
2009-2010,deStuttgart,20,26.1,,10,84,,,10,8,18,10,0,0,14,0
2009-2010,roUnirea Urziceni,21,27.8,,6,70,,,5,2,7,5,0,0,15,0
2009-2010,deWolfsburg,17,26.4,,6,66,,,9,7,16,8,1,1,3,1
2009-2010,chZürich,18,25.4,,10,68,,,5,3,8,4,1,1,14,1
2008-2009,dkAalborg,16,26.3,,10,62,,,7,5,12,7,0,0,8,1
2008-2009,cyAnorthosis,20,29.9,,12,64,,,7,3,10,7,0,0,10,0
2008-2009,engArsenal,24,23.9,,14,132,,,17,12,29,13,4,4,20,0
2008-2009,esAtlético Madrid,22,27.0,,10,88,,,11,8,19,11,0,0,17,0
2008-2009,esBarcelona,23,25.9,,15,144,,,31,27,58,29,2,2,22,1
2008-2009,chBasel,21,25.7,,10,65,,,2,2,4,2,0,0,7,0
2008-2009,byBATE Borisov,19,24.7,,12,68,,,3,2,5,3,0,0,14,1
2008-2009,deBayern Munich,22,28.0,,10,110,,,24,14,38,22,2,2,17,0
2008-2009,frBordeaux,17,27.2,,6,57,,,4,3,7,4,0,0,14,1
2008-2009,sctCeltic,19,26.3,,6,65,,,4,4,8,4,0,1,8,0
2008-2009,roCFR Cluj,18,26.6,,6,66,,,5,2,7,5,0,0,16,1
2008-2009,engChelsea,21,27.5,,12,129,,,20,16,36,20,0,0,30,2
2008-2009,uaDynamo Kyiv,19,24.8,,10,66,,,4,2,6,3,1,1,16,1
2008-2009,trFenerbahçe,20,27.8,,10,66,,,3,0,3,3,0,0,17,1
2008-2009,itFiorentina,19,26.7,,8,66,,,5,5,10,5,0,0,13,0
2008-2009,itInter,23,28.4,,8,87,,,7,7,14,7,0,0,12,0
2008-2009,itJuventus,25,28.7,,10,88,,,9,6,15,8,1,2,19,1
2008-2009,engLiverpool,22,26.1,,12,112,,,20,14,34,16,4,4,17,0
2008-2009,frLyon,22,26.3,,8,88,,,16,11,27,16,0,0,22,1
2008-2009,engManchester Utd,24,26.9,,13,143,,,18,12,30,18,0,0,14,1
2008-2009,frMarseille,18,25.9,,8,66,,,5,5,10,5,0,0,6,0
2008-2009,grPanathinaikos,22,27.6,,12,88,,,10,4,14,9,1,1,15,0
2008-2009,ptPorto,22,25.0,,10,109,,,12,9,21,12,0,0,16,1
2008-2009,nlPSV Eindhoven,19,26.4,,6,63,,,5,4,9,5,0,0,13,0
2008-2009,esReal Madrid,25,26.6,,8,88,,,8,5,13,8,0,0,11,0
2008-2009,itRoma,23,28.2,,8,90,,,13,10,23,13,0,0,16,0
2008-2009,uaShakhtar,22,24.8,,8,66,,,11,9,20,11,0,0,19,0
2008-2009,ptSporting CP,21,26.2,,8,88,,,9,5,14,9,0,0,13,1
2008-2009,roSteaua,20,27.2,,8,67,,,3,3,6,3,0,0,18,1
2008-2009,esVillarreal,21,27.3,,10,106,,,13,9,22,12,1,1,21,3
2008-2009,deWerder Bremen,21,25.9,,6,66,,,7,5,12,6,1,1,17,0
2008-2009,ruZenit,16,27.2,,6,63,,,4,3,7,4,0,0,11,1
2007-2008,engArsenal,24,24.2,,12,110,,,18,16,34,18,0,0,16,0
2007-2008,esBarcelona,24,26.8,,12,141,,,19,13,32,18,1,1,20,0
2007-2008,ptBenfica,20,26.9,,8,66,,,5,4,9,5,0,0,7,1
2007-2008,trBeşiktaş,22,26.5,,10,69,,,3,2,5,3,0,0,4,0
2007-2008,sctCeltic,23,25.9,,10,89,,,6,5,11,6,0,0,12,0
2007-2008,engChelsea,24,28.0,,13,146,,,17,11,28,16,1,1,14,1
2007-2008,ruCSKA Moscow,22,24.7,,6,65,,,6,3,9,5,1,1,14,0
2007-2008,uaDynamo Kyiv,27,26.9,,8,66,,,4,4,8,4,0,0,6,0
2007-2008,trFenerbahçe,21,27.1,,12,110,,,14,8,22,14,0,0,21,1
2007-2008,itInter,24,28.8,,8,88,,,12,9,21,11,1,1,14,1
2007-2008,itLazio,21,28.3,,8,67,,,8,5,13,8,0,1,9,0
2007-2008,engLiverpool,22,26.5,,14,130,,,29,22,51,26,3,3,11,0
2007-2008,frLyon,22,27.1,,8,88,,,12,8,20,11,1,1,13,0
2007-2008,engManchester Utd,26,26.2,,13,144,,,20,15,35,19,1,1,14,0
2007-2008,frMarseille,20,25.1,,6,66,,,6,3,9,6,0,0,10,0
2007-2008,itMilan,23,30.0,,8,88,,,12,9,21,11,1,1,15,0
2007-2008,grOlympiacos,23,30.1,,8,88,,,11,6,17,11,0,0,14,1
2007-2008,ptPorto,22,26.0,,8,88,,,7,5,12,5,2,2,8,1
2007-2008,nlPSV Eindhoven,21,25.9,,6,68,,,3,2,5,3,0,0,9,1
2007-2008,sctRangers,18,27.4,,10,63,,,7,5,12,6,1,1,14,1
2007-2008,esReal Madrid,23,26.2,,8,88,,,15,13,28,15,0,0,12,0
2007-2008,itRoma,22,27.9,,10,110,,,14,9,23,14,0,0,21,0
2007-2008,noRosenborg,16,27.5,,10,69,,,6,4,10,6,0,0,6,0
2007-2008,deSchalke 04,23,25.9,,10,110,,,6,6,12,6,0,0,25,0
2007-2008,esSevilla,24,27.1,,10,82,,,16,10,26,16,0,0,7,0
2007-2008,uaShakhtar,17,25.1,,10,66,,,6,3,9,5,1,1,11,0
2007-2008,czSlavia Prague,23,26.2,,10,65,,,5,3,8,5,0,0,12,0
2007-2008,ptSporting CP,23,24.9,,6,65,,,9,5,14,8,1,1,8,0
2007-2008,roSteaua,21,25.6,,10,66,,,4,3,7,4,0,0,8,0
2007-2008,deStuttgart,21,25.6,,6,82,,,7,4,11,7,0,1,8,0
2007-2008,esValencia,23,27.5,,8,66,,,2,1,3,2,0,0,6,1
2007-2008,deWerder Bremen,20,25.6,,8,80,,,8,6,14,7,1,1,6,1
2006-2007,grAEK Athens,22,27.2,,8,66,,,6,4,10,6,0,0,13,0
2006-2007,beAnderlecht,17,24.9,,6,62,,,7,6,13,7,0,0,11,1
2006-2007,engArsenal,23,25.4,,10,83,,,7,6,13,6,1,1,8,0
2006-2007,esBarcelona,21,27.1,,8,88,,,14,10,24,14,0,0,12,0
2006-2007,deBayern Munich,20,27.4,,10,109,,,16,8,24,15,1,1,19,2
2006-2007,ptBenfica,18,28.1,,8,58,,,6,4,10,6,0,0,6,0
2006-2007,frBordeaux,21,26.8,,6,66,,,6,5,11,6,0,0,6,1
2006-2007,sctCeltic,20,26.9,,8,90,,,8,4,12,7,1,1,15,0
2006-2007,engChelsea,22,26.6,,12,132,,,17,14,31,16,1,1,23,0
2006-2007,ruCSKA Moscow,19,24.4,,8,66,,,4,3,7,3,1,1,15,0
2006-2007,uaDynamo Kyiv,25,25.9,,10,66,,,5,3,8,5,0,0,12,0
2006-2007,dkFC Copenhagen,17,26.5,,10,66,,,5,3,8,5,0,0,6,0
2006-2007,trGalatasaray,24,28.0,,8,66,,,7,3,10,7,0,0,11,2
2006-2007,deHamburger SV,24,25.7,,8,66,,,7,3,10,7,0,0,12,2
2006-2007,itInter,23,29.1,,8,88,,,7,6,13,7,0,0,14,3
2006-2007,bgLevski Sofia,21,27.7,,10,66,,,1,1,2,1,0,0,7,0
2006-2007,frLille,23,25.3,,10,88,,,7,6,13,7,0,0,19,1
2006-2007,engLiverpool,25,25.9,,15,135,,,19,15,34,19,0,0,19,0
2006-2007,frLyon,24,26.9,,8,88,,,12,9,21,12,0,0,17,0
2006-2007,engManchester Utd,21,27.4,,12,132,,,22,17,39,21,1,1,21,1
2006-2007,itMilan,24,29.5,,15,144,,,20,15,35,17,3,3,20,2
2006-2007,grOlympiacos,18,30.0,,6,63,,,6,6,12,6,0,0,12,0
2006-2007,ptPorto,21,24.4,,8,87,,,11,7,18,10,1,1,11,0
2006-2007,nlPSV Eindhoven,21,26.1,,10,108,,,8,6,14,8,0,0,9,2
2006-2007,esReal Madrid,27,27.4,,8,88,,,17,9,26,14,3,3,12,1
2006-2007,itRoma,21,27.1,,10,111,,,13,8,21,12,1,1,24,0
2006-2007,uaShakhtar,21,24.3,,8,65,,,6,3,9,6,0,0,18,2
2006-2007,ruSpartak Moscow,20,26.0,,10,63,,,7,6,13,7,0,0,6,0
2006-2007,ptSporting CP,21,25.1,,6,66,,,3,3,6,3,0,0,13,0
2006-2007,roSteaua,20,25.9,,10,66,,,7,5,12,7,0,0,14,0
2006-2007,esValencia,30,27.0,,12,110,,,15,9,24,15,0,0,21,0
2006-2007,deWerder Bremen,19,25.5,,6,66,,,5,3,8,5,0,0,12,0
2005-2006,nlAjax,21,24.3,,10,87,,,11,7,18,11,0,0,14,1
2005-2006,beAnderlecht,22,26.7,,10,63,,,1,1,2,1,0,0,4,1
2005-2006,engArsenal,25,25.5,,13,142,,,15,9,24,13,2,2,15,1
2005-2006,skArtmedia,18,26.5,,12,66,,,5,3,8,5,0,0,12,0
2005-2006,esBarcelona,22,26.7,,13,143,,,23,12,35,21,2,3,21,0
2005-2006,deBayern Munich,21,28.2,,8,88,,,12,8,20,12,0,0,13,0
2005-2006,ptBenfica,24,26.0,,10,109,,,7,4,11,7,0,0,13,0
2005-2006,esBetis,21,25.5,,8,69,,,3,3,6,3,0,0,18,0
2005-2006,engChelsea,21,26.1,,8,89,,,8,6,14,7,1,1,17,1
2005-2006,beClub Brugge,23,27.1,,8,68,,,6,4,10,6,0,0,8,0
2005-2006,trFenerbahçe,17,25.6,,6,66,,,7,2,9,5,2,2,10,3
2005-2006,itInter,26,28.2,,12,113,,,12,10,22,11,1,3,16,2
2005-2006,itJuventus,21,28.8,,10,110,,,16,10,26,16,0,0,24,4
2005-2006,frLille,22,24.8,,6,66,,,1,1,2,1,0,0,13,0
2005-2006,engLiverpool,21,26.3,,14,90,,,5,4,9,5,0,0,11,0
2005-2006,frLyon,24,26.7,,10,114,,,17,10,27,17,0,1,16,1
2005-2006,engManchester Utd,18,26.1,,8,65,,,3,1,4,3,0,0,15,2
2005-2006,itMilan,21,29.5,,12,131,,,20,16,36,19,1,2,18,1
2005-2006,grOlympiacos,20,29.8,,6,64,,,6,3,9,6,0,0,10,1
2005-2006,grPanathinaikos,20,25.7,,8,66,,,4,3,7,3,1,1,12,0
2005-2006,ptPorto,21,25.5,,6,64,,,6,5,11,6,0,0,12,0
2005-2006,nlPSV Eindhoven,20,26.0,,8,88,,,4,3,7,4,0,0,9,2
2005-2006,sctRangers,23,27.0,,10,85,,,9,6,15,9,0,0,14,0
2005-2006,atRapid Wien,19,27.8,,10,65,,,3,2,5,3,0,0,8,0
2005-2006,esReal Madrid,27,26.6,,8,85,,,9,8,17,9,0,0,15,1
2005-2006,noRosenborg,14,28.1,,8,63,,,5,3,8,5,0,1,2,0
2005-2006,deSchalke 04,15,27.2,,6,66,,,13,5,18,11,2,2,13,0
2005-2006,czSparta Prague,16,26.7,,6,59,,,2,0,2,2,0,0,4,1
2005-2006,chThun,15,24.8,,10,64,,,4,2,6,4,0,0,11,2
2005-2006,itUdinese,15,27.4,,8,61,,,9,6,15,7,2,2,11,1
2005-2006,esVillarreal,24,27.3,,14,143,,,8,5,13,6,2,3,27,0
2005-2006,deWerder Bremen,19,26.9,,10,108,,,14,10,24,12,2,2,14,2
2004-2005,nlAjax,23,23.2,,6,66,,,6,3,9,6,0,1,8,0
2004-2005,beAnderlecht,22,25.9,,8,66,,,4,2,6,4,0,1,8,0
2004-2005,engArsenal,22,26.5,,8,88,,,12,7,19,10,2,2,8,2
2004-2005,esBarcelona,23,25.6,,8,88,,,13,9,22,11,2,4,7,0
2004-2005,deBayern Munich,23,28.1,,10,110,,,20,12,32,17,3,3,16,0
2004-2005,sctCeltic,19,28.5,,6,66,,,4,4,8,4,0,0,12,0
2004-2005,engChelsea,23,25.3,,12,132,,,20,18,38,20,0,0,19,1
2004-2005,ruCSKA Moscow,20,23.8,,10,66,,,5,3,8,4,1,3,8,1
2004-2005,uaDynamo Kyiv,19,24.2,,8,55,,,7,3,10,7,0,0,9,0
2004-2005,trFenerbahçe,19,26.2,,6,66,,,8,6,14,8,0,0,8,2
2004-2005,itInter,26,28.1,,12,99,,,18,14,32,17,1,2,15,1
2004-2005,itJuventus,22,28.2,,12,110,,,9,6,15,9,0,0,23,1
2004-2005,esLa Coruña,21,28.6,,8,67,,,0,0,0,0,0,0,12,0
2004-2005,deLeverkusen,21,27.2,,10,88,,,15,8,23,15,0,0,22,1
2004-2005,engLiverpool,26,26.1,,15,143,,,17,11,28,17,0,1,21,0
2004-2005,frLyon,22,25.6,,10,110,,,29,21,50,28,1,1,10,0
2004-2005,ilMaccabi Tel Aviv,19,23.7,,10,66,,,4,1,5,2,2,2,7,0
2004-2005,engManchester Utd,27,25.8,,10,89,,,14,9,23,13,1,1,10,0
2004-2005,itMilan,21,29.4,,13,131,,,20,17,37,20,0,0,15,0
2004-2005,frMonaco,20,24.9,,10,89,,,10,8,18,10,0,0,10,1
2004-2005,grOlympiacos,19,30.1,,6,66,,,5,3,8,5,0,0,15,1
2004-2005,grPanathinaikos,22,26.9,,6,66,,,10,4,14,9,1,2,12,0
2004-2005,frParis S-G,20,26.7,,6,66,,,3,3,6,3,0,0,8,1
2004-2005,ptPorto,24,26.2,,8,88,,,6,3,9,6,0,0,20,0
2004-2005,nlPSV Eindhoven,20,26.2,,14,132,,,14,12,26,14,0,1,13,1
2004-2005,esReal Madrid,18,28.2,,10,89,,,12,8,20,9,3,4,14,1
2004-2005,itRoma,24,25.0,,6,55,,,4,3,7,4,0,0,11,3
2004-2005,noRosenborg,19,28.7,,10,66,,,6,3,9,6,0,0,3,0
2004-2005,uaShakhtar,20,24.3,,10,66,,,5,4,9,5,0,0,5,3
2004-2005,czSparta Prague,19,25.4,,10,66,,,2,2,4,2,0,0,4,1
2004-2005,esValencia,20,27.9,,6,66,,,6,5,11,6,0,0,15,2
2004-2005,deWerder Bremen,20,26.8,,8,88,,,14,7,21,12,2,2,18,1
2003-2004,grAEK Athens,23,28.4,,8,66,,,1,1,2,1,0,0,10,1
2003-2004,nlAjax,22,23.0,,8,66,,,6,4,10,5,1,1,14,1
2003-2004,beAnderlecht,17,26.0,,10,66,,,4,3,7,4,0,1,12,1
2003-2004,engArsenal,18,27.7,,10,107,,,15,9,24,15,0,0,8,0
2003-2004,deBayern Munich,19,28.0,,8,91,,,6,4,10,5,1,1,20,1
2003-2004,trBeşiktaş,18,30.1,,6,66,,,5,1,6,3,2,2,11,1
2003-2004,esCelta Vigo,21,28.7,,10,87,,,8,5,13,7,1,1,20,1
2003-2004,sctCeltic,19,29.0,,10,66,,,8,8,16,8,0,1,11,0
2003-2004,engChelsea,21,26.2,,14,128,,,14,5,19,14,0,0,17,2
2003-2004,beClub Brugge,21,28.0,,8,66,,,4,4,8,4,0,0,9,2
2003-2004,uaDynamo Kyiv,19,25.4,,8,66,,,8,5,13,8,0,0,7,0
2003-2004,trGalatasaray,22,28.2,,8,66,,,6,6,12,6,0,0,13,2
2003-2004,itInter,22,27.9,,6,66,,,8,5,13,8,0,0,9,0
2003-2004,itJuventus,22,28.4,,8,89,,,15,12,27,15,0,0,16,0
2003-2004,esLa Coruña,22,28.9,,14,131,,,16,5,21,15,1,1,18,2
2003-2004,itLazio,21,29.6,,8,66,,,6,2,8,5,1,1,13,1
2003-2004,ruLoko Moscow,17,27.6,,10,66,,,7,4,11,6,1,1,9,1
2003-2004,frLyon,20,25.8,,10,110,,,10,3,13,8,2,2,12,1
2003-2004,engManchester Utd,22,26.0,,8,85,,,14,9,23,13,1,1,9,1
2003-2004,frMarseille,19,25.5,,8,66,,,9,7,16,9,0,0,7,0
2003-2004,itMilan,24,28.8,,10,113,,,12,2,14,12,0,0,14,2
2003-2004,frMonaco,20,25.5,,13,143,,,25,8,33,25,0,0,18,3
2003-2004,grOlympiacos,20,28.3,,6,66,,,6,5,11,6,0,0,15,1
2003-2004,grPanathinaikos,21,27.9,,6,66,,,5,5,10,5,0,0,12,1
2003-2004,rsPartizan,22,26.5,,10,66,,,3,1,4,3,0,0,6,1
2003-2004,ptPorto,22,27.5,,13,136,,,16,6,22,15,1,1,25,0
2003-2004,nlPSV Eindhoven,19,25.5,,6,66,,,8,4,12,8,0,0,13,1
2003-2004,sctRangers,19,27.5,,8,66,,,4,1,5,4,0,0,8,0
2003-2004,esReal Madrid,19,26.9,,10,106,,,17,9,26,16,1,1,13,0
2003-2004,esReal Sociedad,20,28.7,,8,86,,,7,5,12,6,1,1,11,1
2003-2004,czSparta Prague,21,26.9,,10,85,,,6,4,10,6,0,0,5,0
2003-2004,deStuttgart,21,25.1,,8,88,,,8,7,15,8,0,1,8,0
